cell_barcode	tumor_cell_classification
AAGCATCTCGTTGCCT	Tumor
AGGTCTAAGGGACTGT	Tumor
CTGTATTTCCAAGAGG	Normal
AATTTCCTCTCGAGTA	Tumor
CAGCAGCTCCTCAGAA	Tumor
CCTCAACTCGTTCTGC	Tumor
CATCGCTTCATGTCTT	Tumor
GGGAGTAAGCCACAAG	Tumor
TGTTTGTTCTGCGGCA	Tumor
AGTGCCGCAGCTTCGG	Normal
CGAGAAGTCGCTACGG	Normal
TCCTCTTTCTCTTCAA	Tumor
TCCAGAACAGTAGAGC	Tumor
AGGTCATTCGTACACA	Tumor
TAATTCCAGTTCCGGC	Normal
AAGCATCTCTGTCAGA	Tumor
TCGAAGTTCTGGGCAC	Tumor
CTCAATTGTACTTGTG	Tumor
AGAACAAGTGGACCTC	Tumor
GGAATGGCAATGAGCG	Tumor
CAATGACTCCTTATGT	Tumor
CCACGAGAGGCTAGCA	Tumor
CGAATTGAGACCAACG	Tumor
CATACCCAGAGCTGAC	Tumor
TTCCGGTCAACTTGGT	Normal
TTCTGTATCGGCTCTT	Normal
GGATGTTAGAGCGACT	Normal
GATCATGGTATCGAAA	Tumor
CAAGCTATCGTCGATA	Tumor
GCCAGGTAGCAGCACA	Tumor
TGATTTCCAGCTAACT	Tumor
TTTAGTCCAACTCGAT	Normal
TCTCACGGTCGCATCG	Tumor
ACGATCAAGTCCGCCA	Tumor
GGCTTGGCACCTAAAC	Tumor
TCCTTCTTCCAGTACA	Tumor
ATCACTTCACCGGCTA	Tumor
ACCGTTCCACCTGCAG	Normal
CAACCAAGTACCGGCT	Tumor
CTAACCCGTTAGCTAC	Normal
GTGGGAATCTTCCCGA	Tumor
GGTAATCTCAAGTAAG	Tumor
GAATCGTCAGTCTTCC	Tumor
CACTAAGAGGTGCCTC	Tumor
TCTGGCTGTACGGTTT	Tumor
GAGGCAACATGCACTA	Tumor
TCACATTTCCTTCAGC	Tumor
GCACGGTTCTATACGG	Tumor
GGGAGTATCTGCGGAC	Tumor
TAGACTGCACTGGCGT	Tumor
ATCACAGCACTGTCGG	Tumor
CATACAGGTGCCTACG	Tumor
TACAGGTAGGATGTTA	Tumor
TCACATTTCTTCTCAA	Normal
TCATTACCAACTTCTT	Tumor
AGACCCGGTGCTGTCG	Tumor
TGGGAAGTCCCGAACG	Normal
AGTGACTCAGGATGAC	Tumor
AGCGCCAAGCTGACCC	Normal
TGAACGTAGCAGGTCA	Tumor
AGTCATGCACACCTGG	Tumor
CCTCACAAGACATCCT	Tumor
CGTAGTAGTCTCAGAT	Tumor
TGCATGATCAGAGCGA	Tumor
TCCTAATCATACAGAA	Tumor
TTAGGCATCACGAGGA	Normal
GACCCTTGTGACAACG	Tumor
GAATCACTCGGCCTTT	Tumor
TCCTGCAAGCCGTTAT	Normal
CTCAGGGGTAACACGG	Tumor
GGAGGTATCGAGTCTA	Tumor
CATTGCCAGGGCATGT	Tumor
GAGAAATAGTGATTCC	Tumor
CCACGTTCAAATGGTA	Normal
TTGGGCGGTAGAAACT	Tumor
CCGTAGGAGTCTTCCC	Tumor
TGAGGGACACGGCGTT	Tumor
CTTAGGAGTCCCTAAA	Tumor
AATCGACCACGACGCT	Tumor
TGCTCGTCAGTGGTGA	Normal
GTTGTCCAGTTGCGCC	Normal
TAGTGCACAGAACGCA	Tumor
ATCTTCATCTCAACGA	Tumor
CATAGACCAGCAATTC	Tumor
CATTGTTGTGCCTGAC	Tumor
AGATCGTAGTTTCAGC	Tumor
CCTCAACTCTACTATC	Tumor
CACATGACAAGAAACT	Tumor
AGTGCCGTCGAACGGA	Tumor
TGTCAGAGTTCTCGCT	Normal
TCCTGCACATGACACT	Tumor
TGGAGGATCCCGAACG	Tumor
AGGTCATAGGCACAAC	Tumor
GGATCTACACCAGTAT	Tumor
CCTCCTCAGAATTGCA	Tumor
TCCTGCAGTGGTAATA	Normal
TGCAGATAGCTTTCTT	Tumor
CGTAAGTTCGCGGACT	Tumor
CGAGTGCAGTGAGGCT	Tumor
ACCGTTCAGGATTCCT	Normal
AGCTCAATCACTTGGA	Normal
CGGACACTCCCAGGAC	Tumor
AACAAGATCCACCTCA	Tumor
GAAGCCCGTTGCTCGG	Tumor
TGCTTCGGTCTCAGGC	Tumor
AAATGGATCAGCGCAC	Normal
AACCTTTGTATGAGGC	Tumor
ATCGTCCTCTGCGGCA	Tumor
CAAGGGACAGGTGACA	Normal
ACCACAACAAGTGGTG	Tumor
TCTGCCAGTTCAAGTC	Tumor
AACACACAGTCATGCT	Normal
AGATGCTCAACACACT	Tumor
TAACTTCAGTTCATGC	Tumor
TGACTCCCAACTCGTA	Tumor
ATTCTACCAAGCTGTT	Normal
CACGGGTCAGCTTTGA	Normal
TCGCTCACATCGGATT	Tumor
CACTGTCGTCTCGGAC	Tumor
TCAGCAAAGCGACATG	Tumor
TCGGGACTCCCAACTC	Tumor
CGGTCAGGTCTAGTGT	Tumor
TTCCACGCAAGTGGAC	Tumor
AAGACAATCGATCCAA	Normal
CTCAACCCATACACCA	Tumor
CCTGCATCAGAGCCCT	Tumor
GGCAGTCAGTAAGCAT	Normal
TGCGACGAGGAAAGGT	Tumor
CTTCTCTTCCCTTGTG	Tumor
CTGGTCTGTTCAAGGG	Normal
ATTGGGTCATTGCCTC	Tumor
AGTCATGTCTCCAATT	Tumor
TCACTCGAGCCGTAAG	Tumor
TGCGGCACAATCGCGC	Normal
TTGCATTAGTCATGGG	Tumor
GTGGAAGTCATGAAAG	Tumor
CATTGCCTCTGATGGT	Tumor
GATCCCTAGTATTGCC	Tumor
ATGGATCGTGGCATCC	Tumor
TCCTGCAGTTGCTTGA	Normal
AGCTACATCTGGTGCG	Normal
AGACCCGTCTGTCAGA	Tumor
CTGGCAGGTGACTCTA	Tumor
ATTCTACAGGCTTCCG	Normal
ACACAGTGTGGAAATT	Normal
CATTCCGCATAGGTTC	Normal
CACCAAAGTTCGAGCC	Tumor
AACGAAACACACAGCC	Normal
ATCGGATGTATGAGAT	Tumor
TTGGTTTTCGCCATAA	Tumor
TTAGGGTGTAGCACAG	Tumor
CAGCAGCTCCTACCGT	Normal
CCTATCGCATTGGCAT	Normal
CTTTCGGGTGCGGCTT	Tumor
CAGATACAGCCACCGT	Tumor
ACTATGGCAAGAAATC	Tumor
GCATTAGGTATCCCTC	Tumor
ATTGGGTGTCCACGCA	Tumor
GATGACTAGATGACAT	Tumor
GTCTGTCAGCCGATTT	Tumor
TCCAGAAAGGTGCTAG	Tumor
ATTCCATCACTCCTGT	Normal
ACACCAAGTTCCACAA	Tumor
TATCAGGTCATCTGTT	Tumor
CCAATTTCAGACGCTC	Tumor
CAACGGCAGCAGCGAT	Tumor
GGGTCACTCACTAGCA	Tumor
AAGCGAGAGAGGTATT	Tumor
GCAGGCTAGTGACCTT	Tumor
TCATTTGTCTAGCCTC	Tumor
TGCAGATCAAAGGCAC	Tumor
GTTACGATCCACAAGT	Tumor
TTAGGCAAGAGGGTAA	Tumor
ACTTCGCTCGACTCCT	Tumor
GGGCGTTTCGTCTACC	Tumor
AGATAGAGTTCATCGA	Normal
TATTGGGTCACATACG	Tumor
AGACAAAGTCCACAGC	Tumor
TCCCACAAGTCACTAC	Tumor
AAGAACAAGCTCGACC	Normal
TACGCTCCAGGAGACT	Tumor
CAACCTCCAGACAATA	Tumor
ACAGGGATCGACCTAA	Tumor
AGTCAACAGAGGATGA	Normal
GACATCAAGCAATAAC	Tumor
ATCGCCTTCCGACAGC	Normal
AGTTAGCAGTGCACCC	Tumor
TGAGGGATCTAGCATG	Tumor
CTTCCTTTCCTATTTG	Normal
CTCTCAGGTGTAAATG	Tumor
CACTTCGTCATCTCTA	Normal
GGAGGATAGCCTGTGC	Tumor
ACTCTCGGTTCGGTCG	Tumor
GTAACCACAACAAAGT	Tumor
TATACCTAGGACACTG	Tumor
TGGGCGTTCCGCATAA	Tumor
CCATCACCAGCCTTCT	Normal
TCAGCCTTCGATTTCT	Tumor
TCAAGACCAATAAGGT	Normal
GTCTTTAAGCTGTTAC	Tumor
TTACGCCTCAGTCATG	Normal
TCATGCCAGCCAAGGT	Tumor
ATTCAGGCAGTTTCGA	Normal
ACCCAAAAGAGGATCC	Tumor
CATCAAGAGGGTACAC	Tumor
AGCTCAAAGGCCTTCG	Tumor
TTAGGGTGTGAGTAGC	Tumor
TTCCTAACATACCACA	Normal
CATTGTTAGCACCTGC	Tumor
GTAGGAGGTTCAAGTC	Tumor
CTCACTGTCTGCGGAC	Tumor
TCCCACACACGACGTC	Tumor
CGATGGCGTCATTCCC	Normal
GTGTCCTGTCGACTGC	Tumor
CACGTTCGTTGATGTC	Normal
TCCTCTTAGACCTCCG	Tumor
TGTGCGGGTAGACACG	Tumor
CCCAACTGTTCAACGT	Tumor
CGGAACCGTGAATTGA	Tumor
GTCAGCGAGTCACAGG	Normal
ATCACAGAGGGAGAAT	Tumor
GGCTTTCTCTTTACAC	Tumor
GATCACACACGACGTC	Normal
TTGGGTAGTCTAACTG	Normal
TTTAGTCAGGTTTACC	Normal
ATCCTATTCACGGGAA	Normal
GGGAGATAGGCTGAAC	Tumor
ATTTCACTCTCCGATC	Tumor
GACCAATCAGCTGTGC	Tumor
TCGGATAAGCAAATCA	Tumor
CAGTTAGCAACATCGT	Tumor
TTAGTCTGTATTGGCT	Tumor
ATACTTCCACCCTTAC	Tumor
CACCAAAAGATGCTTC	Tumor
CCTCACATCGCCTCTA	Tumor
TATGTTCCAATTCACG	Tumor
TGACTCCAGCTGTTAC	Tumor
ATTCAGGTCTCAGGCG	Tumor
CCAATGAGTTACACTG	Tumor
CGTCCATCACGGTGTC	Tumor
GCCCGAATCTCGAGTA	Tumor
CTTCGGTAGGGAGTGG	Normal
CATCAAGGTGGAACCA	Tumor
TACCGGGAGATGTAGT	Normal
GTGACGCAGTTGAAAC	Tumor
GTGAGGATCTTAGCAG	Tumor
TACCGGGTCCGAGAAG	Tumor
ATGAGTCTCCAAACCA	Tumor
CGAGGAATCCGCTAGG	Tumor
GTCCACTCAACCGCCA	Tumor
CAAGGGACAACGGGTA	Tumor
TCCATCGCACGAGGAT	Tumor
CAACGATGTATGCTAC	Tumor
AACCCAATCTGTCCCA	Tumor
ATGAAAGCAGTTAGAA	Tumor
AACGAAATCATTCATC	Tumor
ATTTACCAGTTGAAAC	Normal
AGACACTAGACAGCTG	Normal
CTCCGATTCGCATTGA	Tumor
GACCTTCAGGGTTTCT	Tumor
CTCAACCAGCCAAGGT	Tumor
GAAGTAAAGGGTTGCA	Tumor
TGATCTTCACACCTTC	Tumor
TCCTTTCTCGGTGTAT	Tumor
GCAACATCAAGCCATT	Normal
GTTGTAGAGGCATCGA	Tumor
TGCTTGCCACCAGCCA	Tumor
AGAAATGGTGTAAACA	Tumor
CGAAGTTTCGATTGAC	Tumor
TCCGGGATCACCTCGT	Tumor
GTAGAAAAGCAGCCCT	Tumor
AATCACGCACGGTGAA	Tumor
ATCCCTGTCAACGCTA	Normal
CAATCGAGTGTGTCGC	Tumor
ATCCCTGTCAAAGGTA	Tumor
CCGGACATCGTAGGAG	Normal
TCCACGTAGTCTGTAC	Normal
AGATGCTGTTGCCAAT	Tumor
TTTCGATCAGACGCTC	Tumor
GGTAGAGAGGGATCGT	Normal
GGAGAACAGTTAACGA	Tumor
GCAGCCACAAATTAGG	Tumor
CTCAATTTCTTACACT	Tumor
TCGAACACATTACTCT	Normal
GGTGAAGTCAGCTTCC	Tumor
ACACAGTGTAACGTTC	Tumor
TGCATCCTCACTTGTT	Tumor
CCACACTAGGGTCAAC	Normal
TCATTGTGTGATCATC	Tumor
GAGCTGCTCCATAGAC	Tumor
TATGTTCAGAATCGAT	Tumor
GGCTTGGTCCGGACTG	Tumor
ACTATCTAGCTACAAA	Tumor
CTCAGAAAGCGACTGA	Tumor
TGCAGGCAGGCCCACT	Tumor
CGACAGCTCTACAGGT	Tumor
TTCCGGTCAGCACCCA	Normal
TCACGCTAGGTGCTGA	Normal
GTTGTCCAGATGCGAC	Normal
TAAGCGTTCTACCTTA	Tumor
CAACGGCCAGTTGTTG	Tumor
CACATGACAGCATACT	Tumor
CACGAATTCCCTCTCC	Tumor
CCTGCATGTTGCCGAC	Tumor
GCAGCTGTCCGACAGC	Tumor
CGAGTTATCGTGGGTC	Tumor
CTACCCAAGTGTCATC	Tumor
AGAAGCGAGATAGTGT	Tumor
ATCCTATGTCCAATCA	Tumor
AGACCCGCAAATAAGC	Tumor
CAACAGTAGACTGAGC	Tumor
TGACTCCCAGGCTACC	Normal
CATAGACAGCAAGTCG	Tumor
CCTCAACGTATCCTCC	Tumor
TCCACCAGTACATTGC	Tumor
ATACCGATCACCATAG	Tumor
TCAGCAACAGACGCTC	Tumor
CGAGTTAAGTAGCAAT	Tumor
AGGGAGTCAGCTCATA	Tumor
TCAAGACGTACCATAC	Tumor
TCATACTCACGACGCT	Tumor
CTCATCGAGTTTGCTG	Tumor
GGAGAACCACGGGTAA	Tumor
AGTCTCCTCACCATCC	Normal
ATGGGTTTCGCACGGT	Tumor
GACGCTGTCTCTGCTG	Tumor
ACAGCCGCATGGCCCA	Tumor
ATATCCTAGTGGGAAA	Tumor
CTGCCTAAGGCACCAA	Tumor
GTAGATCTCCTGGCTT	Normal
TGAACGTTCTCGCTTG	Tumor
TGAACGTGTTGCGGCT	Tumor
TGTGATGTCGAAGTGG	Normal
CTGCAGGCATGATGCT	Tumor
TTACGCCGTGGCAGAT	Tumor
CCGCAAGGTACTAGCT	Tumor
CTACCTGTCCTCGATC	Tumor
CCCTAACCATCGCTAA	Normal
GACACGCCAGGCTATT	Tumor
TACTGCCGTTACAGCT	Tumor
ACCCTCATCTACACAG	Tumor
CATTGCCCATCATTGG	Tumor
ATCGCCTTCCGGCTTT	Normal
CCTTCAGCAACACAAA	Tumor
ATTCACTCACGGCCAT	Tumor
ATAGACCGTCCCGGTA	Tumor
TAGACCACACTGCGTG	Tumor
TCTCAGCAGTTGCGCC	Normal
CGGGCATTCGCCCAGA	Normal
ATGAGTCGTCTGATAC	Tumor
CAGATCAGTTCATCGA	Tumor
GAGGCAACAACTTGCA	Tumor
TTTACGTTCATTGTGG	Tumor
TCTCCGACACAAGCAG	Tumor
AGGTTGTAGTAACGAT	Tumor
TTAGTCTTCGGCTCTT	Tumor
TTACCATAGTCATACC	Tumor
ACGTAACGTGTGCTTA	Normal
GGGTTATTCATGTCTT	Tumor
GGATGTTAGTATGACA	Normal
ACCTGAAGTTTCCCAC	Tumor
CACTGGGTCTGGACTA	Tumor
AGAAGCGCAAATGAAC	Tumor
CAACGGCTCTGCTCTG	Tumor
TCTCACGTCTTCTAAC	Tumor
CCACTTGAGCCTGTGC	Normal
ACGCACGAGTTCATGC	Tumor
CATTCTATCCCGAATA	Tumor
ATTATCCAGAGAGGGC	Tumor
ACTGTGACACAGTCGC	Tumor
TCTGGCTCAGCAGTTT	Normal
CTACCTGGTCCAGAAG	Normal
TGAGGTTCAGGATCTT	Tumor
CCTATCGTCCACTGAA	Normal
GTGACGCCAAGGCGTA	Tumor
CTCCTTTAGGCAGGGA	Tumor
CCTTGTGCATAGCTGT	Tumor
TCATACTGTACCAATC	Tumor
CCTCTAGAGGTTAGTA	Tumor
GACGCTGCAGTGCCTG	Tumor
GAACACTCAATGAACA	Tumor
CTAACCCAGGTACAGC	Tumor
TCATACTTCCATTTCA	Normal
CTAACCCAGACGCAGT	Tumor
GACTCAATCAAGTTGC	Tumor
GATAGAATCAACGCTA	Tumor
TAAGCCAAGCTTCATG	Normal
CACCGTTTCCGCTAGG	Tumor
CTGAGGCTCCCGTTCA	Tumor
TCCACCACAGGACATG	Tumor
CCTTCAGCAGAGTCTT	Tumor
CACGTTCGTAGTTACC	Tumor
ATTATCCCATTGTAGC	Normal
CACATGAGTCTGATAC	Normal
TCCCAGTAGAAACCAT	Tumor
AGTGCCGAGGCTGAAC	Tumor
CTCAGTCAGAAGCGGG	Normal
TGGATGTGTGACCGTC	Tumor
AGACCATAGTTTGAGA	Tumor
AACCTGAAGCTGCGAA	Tumor
ATGCATGTCGCCTAGG	Tumor
GAGACCCCACACCGCA	Tumor
AGACCATCAATCGTCA	Tumor
ATTCCTACACGCTGTG	Tumor
ATCGTAGAGCTCCATA	Normal
CTACTATTCGAGCCTG	Normal
ATGCCTCGTCACGACC	Tumor
CTGAGCGGTGCCCAGT	Tumor
CCTCAGTCACTGGCGT	Tumor
AGGGAGTAGAACCGCA	Tumor
TGAGACTTCCTGTAGA	Tumor
TTTATGCGTCCCTAAA	Tumor
ACCAACACACTAACCA	Tumor
CACAACAGTGGATACG	Tumor
TACGGGCGTCTCAGAT	Normal
GTAATCGTCCTATTGT	Tumor
CCACGTTCAGGACAGT	Tumor
TCACGGGAGCCACAAG	Normal
CGGGACTGTAGATTGA	Tumor
TCTAACTCAGACCGCT	Tumor
GCGTTTCAGATGGTAT	Tumor
GCACATATCTCTGACC	Tumor
GCTTCACGTGCACATT	Tumor
ACCATTTCAGTTCCAA	Tumor
CTACATTGTGTTAAAG	Tumor
CAAAGAAAGCGACATG	Tumor
CTTCCTTTCATTGAGC	Tumor
GGGTATTAGTAACGTA	Normal
AGGTCATTCTGCGTCT	Normal
GAATCGTTCACACGAT	Tumor
ACTGTCCAGACCAGCA	Tumor
CTTTCAATCCTAGCGG	Tumor
AACAACCAGGTCATCT	Normal
TAAGCGTCATTGTAGC	Tumor
ACATGCATCCCGAGAC	Tumor
CTTTCGGCAATAGTGA	Tumor
AACACACTCGGTGAAG	Tumor
ATTGTTCAGTGAGGCT	Tumor
CATTTCACAAGCTACT	Tumor
AGTCTCCAGCAGGCAT	Tumor
GTGCAGCGTCATGACT	Tumor
GTAGTACAGCACTCTA	Tumor
TGTGGCGAGCCTGAAG	Tumor
CTCATCGAGCCATCCG	Tumor
ACACCAACAACTGGTT	Tumor
CTTACCGCAAGATTGA	Tumor
GTCTAGATCGTAGCCG	Tumor
TGACCCTAGTAAGGGA	Tumor
TTCTTCCGTACAGAAT	Tumor
AGTCATGTCTTTCTAG	Tumor
TTGCGTCAGAGAGCGG	Tumor
AGCGCTGCACCCAAGC	Tumor
ACGCACGCAGGAGGAG	Tumor
AGTCACAAGGATGTTA	Tumor
CGTTAGACAGGATCTT	Tumor
GTTTACTGTTGGACCC	Tumor
CAAGAGGGTAACGATA	Tumor
AATGGAAGTACAGGTG	Tumor
AGAGCCCTCGACCCAG	Tumor
ACTTTCACATATGAAG	Tumor
ATTTCTGCAATACCTG	Normal
ATCCTATCACTCCTTG	Tumor
CTCAGGGCAAATTAGG	Tumor
GCCAGCAGTGTCGCTG	Normal
TCGGTCTAGGAAGTAG	Tumor
GGCTGTGTCACCTGTC	Tumor
GGCTTTCCAATCACGT	Tumor
TATGTTCCATCACCAA	Tumor
CCTCAGTAGGTTATAG	Tumor
AACACACTCATTCATC	Normal
TGATCAGAGAAAGCGA	Tumor
CAAGCTATCCTCTCTT	Tumor
AGGGCTCCATGCCGGT	Tumor
GTTCTATAGACCGTTT	Tumor
TCTCAGCAGGAACATT	Normal
CAGGCCATCGAGAGAC	Tumor
TATCTGTCATCTAGAC	Tumor
GTCATCCTCTCTTGCG	Tumor
TAACCAGAGAGAATCT	Tumor
TCTTGCGAGCTAAGTA	Tumor
GGGAAGTTCTCGGGAC	Tumor
CGGGCATAGCACTAGG	Tumor
ACTATGGAGACCCTTA	Tumor
AATGGCTAGACTCGAG	Tumor
TACTTCAGTTCCGTTC	Normal
GGAGGTACAGTGGCTC	Tumor
TTCTAACCACAGCGCT	Tumor
TGAGCATGTGGTCAAG	Tumor
AGAACAAAGGATGAGA	Tumor
TGGGAGAAGAGCATTA	Tumor
TGAGGAGGTACTCAAC	Tumor
CAGCGTGTCGTCGCTT	Tumor
TGCAGGCTCGTAGCCG	Normal
TGGTGATTCTGGTTGA	Normal
ATGCGATTCGATGCAT	Tumor
ACTCCCATCGGCTATA	Tumor
TACGGTACACCCTTGT	Normal
CTTCAATCAAGCACAG	Tumor
ACGGTCGTCCAATGCA	Tumor
TGTTCATCACACACTA	Normal
CAGGTATCAGGGTCTC	Tumor
CGAGGCTAGATGCTGG	Tumor
CCGGTGACATGGACAG	Tumor
TAGGGTTAGAAGCGCT	Tumor
ATGAAAGAGCCATCCG	Tumor
CATCAAGAGGCTATCT	Tumor
TCAATCTAGGTTCACT	Normal
CATGCAACACTTGACA	Tumor
TCATTACCAACTACGT	Tumor
TGAGTCACAGAATGTA	Tumor
CTCCCTCTCAAAGACA	Normal
GAAACCTCAACAGATA	Normal
TACGCTCGTTTCGATG	Tumor
CATTGCCAGTCTGGAG	Tumor
ATCATTCAGTCTTCGA	Tumor
CATCCGTTCACTTGTT	Normal
GAGTGAGTCCTCTTTC	Tumor
CCATCACGTATGATCC	Normal
GGATGTTGTCGCAACC	Tumor
ATATCCTTCGGAACTT	Tumor
TGTCCTGAGATGATTG	Tumor
AGGACTTGTACCATAC	Tumor
AAAGGGCGTCGAAACG	Tumor
GCTACCTCAGAGATGC	Tumor
GCAGGCTTCTGCCCTA	Normal
GACAGCCAGAGTAACT	Normal
GTTAGACTCACATTGG	Tumor
AAGACTCCACTTGACA	Tumor
TCAGGTAGTCCTCATC	Normal
GGGACTCCACTCTGCT	Normal
GGGCCATTCAAGCCCG	Tumor
GACCCTTGTATTGACC	Tumor
TGATGGTTCCGCAAAT	Tumor
CCAAGCGAGCAGCGAT	Tumor
CTCTCAGGTACCAGAG	Tumor
TTGCCTGTCCATTCAT	Tumor
ACACGCGGTCAGATTC	Tumor
AGTACCAAGCACCTGC	Normal
ATCACAGAGTCGAAGC	Normal
TCTTCCTGTACCGGCT	Tumor
CTCCACAAGATAGTGT	Tumor
TATCGCCGTAGCTTGT	Normal
GTAACACAGTGGATAT	Normal
GGTGTCGAGTAACCTC	Tumor
CTGGTCTCAGTAACAA	Tumor
TGAGGGAAGCGTTCCG	Tumor
ACGTAACAGATTAGTG	Tumor
CTAGGTATCGTGTTCC	Tumor
AATGCCAGTGTCCACG	Tumor
CATCAAGCATGGCTAT	Tumor
TAACACGCAGGAATCG	Tumor
GACCGTGGTGTACATC	Tumor
TTCGCTGAGCCTGCCA	Normal
TAGAGTCCATGCGTGC	Tumor
TTCAGGACAATACAGA	Tumor
GAAACCTGTTGGTGTT	Normal
AGGCCACGTGAAGCTG	Tumor
ACATGCATCGTCAAAC	Tumor
TTCTCTCGTACTCCGG	Tumor
CACAGGCCAACATCGT	Tumor
CCCGAAGAGTCAGCCC	Tumor
CGATGGCTCAAGTCTG	Tumor
TCACATTGTGACTAAA	Tumor
GGGTGAACAGTCTGGC	Tumor
GCAGCTGGTTGCATAC	Tumor
GTAAGTCCAATTGAAG	Tumor
CTATCCGGTGGTCCCA	Tumor
AGGGTTTCACCACTGG	Tumor
CTGCATCGTACAGGTG	Tumor
TGTACAGTCCAACTAG	Tumor
CCACCATCAGCTCATA	Normal
AAGTGAAGTTATTCTC	Tumor
TCAATTCAGAGCTTTC	Tumor
CCTTTGGTCCATACTT	Tumor
TCAAGCACAGCACGAA	Tumor
ACACTGACAGGGCTTC	Tumor
ACGTCCTCAAGTGGTG	Tumor
CTCCCTCTCGGCACTG	Normal
ATTTACCTCCAGTGCG	Normal
CACAGATTCAGTGTTG	Tumor
TTACCATAGGTTAGTA	Tumor
GGGTCTGTCAGCTCTC	Tumor
ACAGGGAAGAAACTAC	Tumor
CCGCAAGAGAGGATGA	Tumor
TCCTGCATCACATCAG	Tumor
TAAGTCGCACTGCGAC	Tumor
CGTAAGTTCGGTGCAC	Tumor
CCTCATGCAACTACGT	Tumor
ACTTTCATCGTCAAAC	Tumor
TGTAACGCAGGAGGTT	Tumor
GACGCTGCAATTGTGC	Tumor
CTTCTAATCCATACAG	Tumor
GGAACCCGTCAGGCAA	Tumor
CTACGGGAGGTGCCTC	Tumor
TCGAACAAGCAGCGAT	Tumor
ACACTGAAGTCAGCGA	Tumor
ACGCACGAGACAACTA	Tumor
TCAGCCTCAACTCGAT	Normal
AACCACATCGCAACAT	Normal
CTTCCTTGTCTGTAGT	Tumor
GCGATCGTCAGGGATG	Tumor
CGTAGTATCGGCACTG	Tumor
TCTGCCACAAACACGG	Tumor
AACCTTTTCGCTATTT	Tumor
GAAATGACAAGACAAT	Tumor
TACATTCCAAAGGCTG	Tumor
GTGGCGTAGCCTCAGC	Tumor
AGATCGTGTGTCTTGA	Tumor
TTCTTGAAGGTGATCG	Tumor
CTCCGATCAGCCGTCA	Tumor
CCTCACACACCTCAGG	Normal
TTTGTTGCATCTTTCA	Tumor
CCACTTGAGCTGGCTC	Tumor
TACGTCCGTCCAAAGG	Tumor
AGAACAATCGGCTTCT	Tumor
TTGCATTCAGTCGCAC	Tumor
GAACGTTGTCTCGGAC	Tumor
TCACTCGCAACGAGGT	Tumor
AAGCGAGTCGATTGGT	Tumor
GTTAGACGTACCAGAG	Normal
GAGGCCTAGAATGTTG	Tumor
TCATACTAGTAGTCCT	Tumor
CTCTCGACACGTGAGA	Tumor
TCAGTCCCAATGTGGG	Tumor
GTTACCCCACACACGC	Tumor
GTAGAGGCACGCACCA	Tumor
GTTTGGAGTCAGTTTG	Normal
ATGACCATCTTGGCTC	Tumor
ATTCCATCAGCTACAT	Tumor
CCTTGTGCAGAGGACT	Tumor
ACCATTTTCAAAGCCT	Tumor
AAAGGTACAAGTTTGC	Tumor
GACCCTTAGCGCCCAT	Normal
TGGGAAGTCGTGAGAG	Tumor
CAGGCCAAGTCAGCGA	Tumor
ATGGGAGAGTAAACGT	Tumor
AATTTCCCAATCCTTT	Normal
AGTAGTCAGCGTTCAT	Tumor
TCAATCTTCCCTTCCC	Tumor
TGAGGGAGTTGTACGT	Tumor
ACTATGGTCGTCTAAG	Tumor
AAGCGTTAGCAAACAT	Normal
AAGACAAGTTAATGAG	Tumor
TTACCATCAGGATCTT	Normal
AGGCTGCGTCCAGGTC	Tumor
AATCACGAGCCATTGT	Normal
CACGAATAGGGTGGGA	Tumor
CTCCGATCAGACGGAT	Tumor
GAAGTAACAACAAAGT	Tumor
ATGATCGTCTTCGACC	Tumor
AGTCAACCACTGGACC	Normal
CTAACCCAGAATTCAG	Normal
GCTTCACAGGAACGCT	Normal
TATACCTTCTGGGCAC	Tumor
ATGGGAGGTCGATTAC	Tumor
CTCAATTGTGATCGTT	Tumor
CTCAATTTCTGCGGGT	Tumor
CTGGACGAGGCTGGAT	Tumor
GTATTTCAGTCGTTAC	Tumor
TACGTCCTCCATTGCC	Normal
ACCCAAATCCATGAGT	Tumor
GCCAACGCACATACGT	Tumor
AATGCCACAGTCACGC	Tumor
TAGACTGGTTCAGCTA	Normal
TCGCTTGGTAACAGGC	Normal
GGAGCAATCCCAACTC	Tumor
AGTAACCTCTGCTTTA	Tumor
GACTATGGTTGCATAC	Tumor
TGCGGCATCCGGCTTT	Tumor
GTAATGCTCCGGTTCT	Tumor
CTCCTTTCACCATTCC	Normal
CTCAAGACACAACGTT	Tumor
TTTACTGTCAAGCTTG	Normal
TTCCACGAGCACCCAC	Tumor
ATCGCCTCACATCCCT	Tumor
CGGAATTGTCCAATCA	Tumor
AGAACCTAGGACGCAT	Tumor
TTGCTGCTCTTTACAC	Normal
TATTCCATCTAGGCAT	Tumor
TTGACCCTCCTACAAG	Tumor
GTCCTCAGTCCCTCAT	Tumor
ATTCTACTCGCTTAAG	Tumor
AACCACAAGCTTTCCC	Normal
GCCAGCAAGACTGTTC	Tumor
CGAGAAGCAGTTCTAG	Tumor
TTCGCTGCAACCGTGC	Tumor
TTGTTGTCAGTCGTTA	Tumor
TGATGCATCCATACTT	Tumor
GAGGCAAGTTATGGTC	Tumor
ATATCCTGTAACTTCG	Tumor
CTCACTGCACTCTAGA	Tumor
GTGGAGACAGTGGCTC	Tumor
AGGGCCTGTGATTGGG	Tumor
CCAATGATCCATACTT	Tumor
TCTTGCGGTTAAGACA	Normal
AAGAACAAGGTCGAGT	Tumor
CTCATCGCAACGAGGT	Normal
CCTCACACATGACTGT	Tumor
GTAACACGTAGCTAAA	Tumor
TAACACGCATTCTCCG	Tumor
AGGAATATCTATCGTT	Normal
ATCATTCTCATCACCC	Tumor
CCTAACCTCCGCAACG	Tumor
GCAACATAGGACATCG	Normal
TCATCCGCAAATTGCC	Normal
ACCGTTCCAATAGTCC	Tumor
GCCAACGAGCAGCAGT	Normal
ATGGTTGAGTGAGTGC	Normal
AACAAGACACATAACC	Normal
TCCGATCCACACACTA	Tumor
AGGCCACTCGCTCATC	Tumor
ATCGTCCTCTGTAACG	Normal
CGGACACGTAGGTGCA	Normal
CACTGAACAGACTGCC	Tumor
CATACTTTCCACTTCG	Tumor
TTCAATCTCCGCTTAC	Tumor
GGAGCAAAGTCACGAG	Normal
AGCCAGCAGATTTGCC	Tumor
CCACACTCATACAGAA	Tumor
GAAGGGTAGGCATGGT	Normal
CATGAGTCATGGATCT	Normal
GTGGGAATCAAGTCTG	Tumor
AACCTGACATACCACA	Normal
TATTCCATCATTCACT	Normal
GGCTTTCCACATTCTT	Tumor
GGGCCATCATCCGCGA	Tumor
TATTGCTCACATTCGA	Normal
TCCGATCTCGCTAATG	Tumor
ATAGAGATCTCGACGG	Tumor
TTCAGGACACTGCACG	Tumor
GAGACTTAGACTACCT	Tumor
CAGCGTGGTCAGGAGT	Tumor
CTGAGCGGTCTTTATC	Tumor
TCTCCGACACAGTCAT	Tumor
TGTAACGCAATTTCGG	Tumor
AGATAGAGTCACAATC	Normal
TCCATGCCAAGAATGT	Tumor
AGGAAATAGGGACCAT	Tumor
TGAATCGCATGATGCT	Tumor
TAACTTCCAGACATCT	Tumor
CATGCAAGTCCTCAGG	Tumor
AATGACCGTTCTCTAT	Normal
GCCAGTGTCAGGAAAT	Tumor
CCGCAAGAGTCGCCAC	Tumor
TGTTGAGTCAACTGAC	Tumor
TGTCCACTCACAGTGT	Tumor
TACCGAAGTGCTGATT	Normal
GGGACCTAGACTCATC	Normal
ATCATTCCAGACCCGT	Tumor
TACAGGTCATCGATGT	Tumor
TCATGCCGTTGGTAGG	Tumor
TTTACGTGTCCGACGT	Normal
CCCGGAAAGTCATCGT	Tumor
TAAGTCGGTCATGACT	Tumor
ATAGACCAGGACTTCT	Normal
TGAATGCGTTAAGAAC	Tumor
AGTTAGCAGGTGCTGA	Tumor
CAATTTCAGTTTCAGC	Tumor
CGAGGAAGTACGCTTA	Tumor
GAAGAATTCCACGGAC	Tumor
TTCTGTAGTGGTAATA	Tumor
TTTGGTTAGTAAGACT	Tumor
CCCTGATCATTGTAGC	Tumor
AAACGCTAGGATTCAA	Tumor
GTTCGCTCAACTCGTA	Tumor
AGGAGGTTCCACTAGA	Tumor
TCATACTTCATTTCGT	Normal
TAGACTGCAATTTCTC	Tumor
GCTACCTGTCTCGGAC	Tumor
TCAAGCAAGCGAGTCA	Tumor
TTAATCCAGGGTTAAT	Tumor
CCTCAGTAGGTTCTAC	Normal
AATCACGAGACTCTAC	Tumor
CTGGTCTGTATCCCTC	Tumor
ATCGTAGGTATCCCTC	Tumor
TCTGTCGTCCGTGACG	Tumor
TATACCTTCGAACGCC	Tumor
GTCCACTCAAATCAAG	Tumor
GTCACTCGTATGGTAA	Tumor
TAAGCACGTATTTCGG	Normal
AGAACAAGTAGGCTCC	Tumor
TTCACCGTCCTGGTCT	Tumor
AGCATCACAGGAATAT	Tumor
GATAGCTCAATGCAGG	Tumor
CGAGTTACAGCTACCG	Normal
CCGGGTATCCGAGGCT	Tumor
TATCGCCCACGAGAAC	Tumor
CTCAACCTCAGGACGA	Tumor
TATCTGTCAAGACTGG	Tumor
TTGAGTGAGTAGCATA	Tumor
TCAATCTTCACTCGAA	Normal
GTCACGGCACCAACAT	Tumor
AGTACCACAAGCCTGC	Tumor
ACTGTCCAGGGCAACT	Tumor
GATTTCTTCCCACAGG	Tumor
GTGTTAGAGTGCCTCG	Normal
TGACAGTAGTCTTCCC	Tumor
ACGGTTATCTTCTTCC	Normal
AAGTCGTAGACGGTCA	Tumor
CAGGTATTCACGGGAA	Tumor
GTGCAGCCAGCTGTCG	Tumor
CATTTCATCACTAGCA	Tumor
CAAGGGAAGGGTACGT	Tumor
GACGCTGGTTCTCGCT	Normal
AGACAAACAAACACCT	Tumor
TTTGTTGTCCGATTAG	Tumor
TAGCACAGTACTCGTA	Tumor
AGAACAAAGTAAGACT	Tumor
CTAACCCTCCATACAG	Tumor
GGGCTACCAGCCTTCT	Normal
TTTGGTTGTTCTCTAT	Tumor
TGGATGTGTTTCGGCG	Tumor
GTGGAAGCATCAGCAT	Tumor
GCTTCACAGGTTAAAC	Tumor
TGGGCGTGTCGTTTCC	Tumor
GACCGTGGTCGTCATA	Tumor
TCCTTCTGTATCAAGA	Tumor
ATTCATCGTTCAAAGA	Tumor
GTATTGGGTCGATGCC	Normal
CACTAAGCATCCTTGC	Tumor
GTGATGTTCTGCGGGT	Tumor
TGATGGTTCTTCGCTG	Normal
GGTAATCCACAACATC	Tumor
CTTCTAAAGCTGCGAA	Normal
CATTGCCCACACGGTC	Normal
CGAGTGCTCTTTGATC	Tumor
AAGCGAGGTTGTCTAG	Tumor
CACAACAGTGGACAGT	Tumor
CATGGATGTCGCATGC	Tumor
TGACTCCGTCCTCATC	Tumor
CAGGGCTAGAAGAGCA	Tumor
TGATGCACACCGAATT	Tumor
CCAAGCGCATTGAGCT	Tumor
GGATCTATCGCTACAA	Tumor
TCCTCCCTCTTACACT	Normal
CGTAAGTTCGGATAAA	Tumor
ACACAGTTCAAGCTGT	Tumor
TGAATGCTCGGAGATG	Tumor
GGAGAACCAAGCACAG	Normal
ATGGTTGTCATAGCAC	Tumor
GACCGTGGTTGACTGT	Tumor
GACCTTCCAGTCACGC	Tumor
ATCGTAGCACATAGCT	Tumor
CGGTCAGTCTAGATCG	Normal
CGCGTGAAGGCAGGGA	Tumor
TGCGACGGTAAGATTG	Normal
CAATGACAGCCTTCTC	Tumor
GTTCATTTCCTTATAC	Tumor
TGTGCGGCATCTAGAC	Tumor
ATTTCTGGTGAGTCAG	Tumor
TAAGCCAAGCTTGTTG	Normal
CAATCGAAGGGAGTGG	Tumor
GTGGTTAGTTGGTAGG	Tumor
CGATGGCAGCACCAGA	Normal
CCCTAACGTGGGTCAA	Normal
CAAAGAAAGTGCACTT	Tumor
TGGAGGAGTACCGTCG	Tumor
TGATCAGAGTTTCTTC	Tumor
CGACAGCAGTTGGAGC	Tumor
CTCCTCCGTGGCAGAT	Tumor
TGGATGTAGTCCCGGT	Tumor
TGTTACTTCGTGAGAG	Tumor
GATTTCTAGGGAGATA	Normal
GAGACCCAGTAGCAAT	Tumor
AGGCATTTCGAAACAA	Tumor
TTCACGCAGAGCATCG	Tumor
GTAGCTACACGATAGG	Normal
AGAGCCCTCCCGAGGT	Normal
ACTATGGTCGCACGGT	Normal
TATGTTCAGATACATG	Tumor
TTACGTTTCCTTTAGT	Tumor
GTATTTCCAGCTATTG	Tumor
GAATAGACAGAACGCA	Tumor
TTGTGGATCGACGAGA	Normal
TGATGGTAGATGCTAA	Tumor
GAGATGGCATGGTACT	Tumor
CGAAGGAAGTAGGATT	Tumor
CAATACGTCACCCATC	Tumor
TTTGACTTCATTTCCA	Tumor
CAGTGCGGTCAATCTG	Tumor
TTGCGTCCAGAAACCG	Normal
TCATCATAGAACAAGG	Tumor
AACAAGAAGAGAGCAA	Tumor
ACGATGTGTACCCGAC	Tumor
CTCCTCCGTTCTGAGT	Tumor
CATTCCGAGTGATAGT	Tumor
TCGCAGGAGGGAGTGG	Tumor
TTCTAACCATAAGATG	Tumor
ATTATCCGTTCGGGTC	Tumor
ATTCCCGGTACGCGTC	Tumor
GTGGTTATCACACCGG	Tumor
CTCAGGGGTGACACGA	Tumor
TTTCATGCACCAAAGG	Tumor
CTACCCAAGGGCAATC	Tumor
GGAATGGCAGAGAAAG	Tumor
AACCTGACAACATACC	Normal
CTGCTCAAGCTCCGAC	Normal
GCAACCGCACATATGC	Tumor
CAAGACTTCTCAATCT	Tumor
AAGTACCAGTAGGTTA	Tumor
GCTTCACCAGGTACGA	Tumor
CCCTCTCCAAAGAACT	Tumor
ACCGTTCAGATTACCC	Normal
AATGCCAAGGATCACG	Tumor
TTCGATTCACAGTCCG	Tumor
CCTCCTCTCTTGCAGA	Tumor
CCTCTCCCAGTCAGTT	Normal
AGACCATGTACAAGTA	Tumor
TCAGGGCAGTGATGGC	Tumor
GTTCATTTCGATCCCT	Tumor
GAATCACTCCCTTGGT	Tumor
ATGGTTGCATAGTCAC	Normal
TCAGCCTAGTGCCCGT	Tumor
ATTCCATCATCTCGTC	Normal
CTGTACCGTGCCTATA	Tumor
TGGAACTTCGCACGAC	Tumor
TAAGCCAGTTCTCCTG	Tumor
ATACCTTAGTAACAGT	Normal
AGCGTATCAGCGGATA	Tumor
TTTGTTGCAGCCGTCA	Tumor
AGCCACGTCGGTGTTA	Tumor
CAAGACTCATGCAGGA	Tumor
ATTCCTATCGCTGATA	Tumor
TGTTCCGCAGTAACCT	Normal
TTCCGTGGTTCGGTAT	Tumor
TCCTTTCTCCGCGGAT	Tumor
ACAGAAATCTGTAACG	Tumor
AGAAGTACACATGACT	Normal
TCACAAGTCGGACGTC	Tumor
ACACGCGTCCTCTCGA	Tumor
ATTTCACGTCCGGTCA	Normal
GCCAGCATCTTCCACG	Tumor
TGATGCAGTCAAACGG	Tumor
CTCAGAACACCGCTGA	Normal
CCGGTAGGTCGCTCGA	Tumor
TACGCTCAGAGTCTTC	Tumor
GTAGTACTCGGCTATA	Tumor
TCGAACACACGATAGG	Tumor
GACAGCCAGCTACTAC	Normal
AAGAACACAGTAGATA	Tumor
ACACTGATCATTTGGG	Tumor
TGCGATATCCTCTAAT	Tumor
TCTACCGGTACGCGTC	Normal
ATTCACTTCCTACTGC	Tumor
ACCTACCTCTTCGGAA	Tumor
AACCACACATATAGCC	Tumor
ACATCCCAGCTGGCTC	Tumor
CCTAACCTCGTTCTAT	Tumor
CGTGCTTCATGTTCGA	Tumor
ACCTACCCAGCGTATT	Tumor
TTTACTGAGGTGATCG	Tumor
CACTGTCCAAGGATGC	Tumor
CCTAACCAGCCTGAGA	Normal
TCTGGCTGTATCGATC	Tumor
TTAGTCTTCATCAGTG	Tumor
GTTGCTCCAAACACGG	Normal
TACGGGCGTTACCCTC	Tumor
CATGAGTCATCCGAGC	Tumor
TGTTTGTAGCCTCACG	Tumor
AGCTCAAAGGTTGGTG	Tumor
CGAGTTACAACGATCT	Tumor
TTCCGGTCAAGTTCGT	Tumor
CTGTACCTCTCGACGG	Tumor
TCTCAGCCAAGAGGCT	Normal
AGTACCAGTTGCTTGA	Tumor
TACTGCCTCACGTCCT	Tumor
CTACTATGTCCGTACG	Tumor
CGCCATTAGGATTTGA	Tumor
ACACTGATCGAACCAT	Tumor
CTGCATCGTTACCCTC	Tumor
GTAGCTAGTAGCTGTT	Normal
ATGAGTCTCGTTGCCT	Tumor
TATTGGGCAATTCTCT	Tumor
GAATCGTCAGTAGAAT	Tumor
ATCATTCCACGGTCTG	Tumor
CCAATTTCATCTGTTT	Tumor
TCATGAGAGTAAACAC	Normal
CGTAAGTGTAACATCC	Tumor
ACAACCAAGACGCCAA	Normal
ACAAAGACAAGTATAG	Tumor
TGAATCGCACAGTCCG	Tumor
ATGAGTCTCGTTCCCA	Tumor
TACACCCAGTATTGCC	Tumor
AATGCCAAGAAAGCGA	Normal
GAAATGATCCTAGCTC	Tumor
GGTTAACTCCCAACTC	Normal
ACATGCAGTTGCCATA	Normal
CCCTCAATCATGCCAA	Tumor
AGTGTTGCAGCTACAT	Tumor
TACCCACCACGACAGA	Tumor
TACACCCAGCCATCCG	Tumor
AAACGAACACCCGTAG	Tumor
CAACCAACACTTCCTG	Normal
TACTTCACATAGATCC	Tumor
ACCTACCAGACGCTCC	Tumor
TTACCATCACCAGCGT	Tumor
GGAACCCGTAGACAGC	Tumor
TCTTCCTCAACCACAT	Normal
CGAAGTTTCGAACACT	Tumor
CCCAACTGTTGCGTAT	Normal
GAAGTAAAGACACACG	Normal
TTACCGCAGCCTGCCA	Tumor
AGTCTCCAGCCATATC	Tumor
GCCAACGGTGGCTAGA	Tumor
GCTTTCGCACGTACTA	Normal
CATGCGGCACTACACA	Tumor
CAACAACAGGGCCCTT	Normal
CGGAACCAGACACACG	Tumor
TCATTACAGTGGAAGA	Tumor
CGACAGCCAAGATGTA	Tumor
CACAGATTCTAGTACG	Tumor
AAGTGAACAGGTGTGA	Tumor
GTGAGCCGTGCCTTTC	Tumor
GGTAGAGCAAACTAGA	Tumor
TTGGGTAAGCAATAAC	Tumor
TTGCGTCTCAAAGCCT	Tumor
CGTCAAAGTGACGTCC	Normal
GAGGGATGTTCTCTAT	Tumor
CTTCCGACAGCATCTA	Normal
TCAGTTTTCTGGCCTT	Tumor
TCAATTCTCAAGCCGC	Tumor
TAGACCAAGCGAGAAA	Tumor
CGTAATGAGCCTGTGC	Tumor
CCGGGTATCGTAACCA	Normal
CATCCCACACGCGGTT	Tumor
CGAAGTTAGATCCCAT	Tumor
TGTAAGCGTGAGCTCC	Tumor
ATAGGCTAGCTGAAGC	Tumor
GAGGCCTCAAGCGCTC	Tumor
CAACGATGTACGTTCA	Normal
GTGGCGTTCAGTCTTT	Tumor
GTACAACTCGAAGAAT	Tumor
GTTTACTGTGGGTCAA	Tumor
TAATTCCAGAATCTAG	Tumor
CACAGGCAGCGTTACT	Tumor
AACAAGAAGCACTCTA	Tumor
CCTCCTCCATCGTGGC	Normal
CAGCAGCTCAGCTAGT	Tumor
GATGGAGCAGGCGTTC	Tumor
GCTTGGGTCTCTCTTC	Tumor
TCTCAGCTCGCCAACG	Tumor
CTCCGATTCCAAATGC	Tumor
ATTACCTTCACACGAT	Tumor
TCGCTTGTCAACCTCC	Tumor
AAGTCGTCACGACGTC	Tumor
CAGGCCACAAAGAGTT	Normal
CGATGCGTCAGCTAGT	Tumor
CTGTGAAAGCCTAGGA	Tumor
CCTACGTAGCGACCCT	Normal
ATGGTTGAGCCTTTCC	Tumor
ACTTATCGTAACAGGC	Tumor
TCCGGGACATGGATCT	Normal
ATCCGTCCAACTGCCG	Tumor
ATGACCAAGCGCACAA	Tumor
AGACTCATCGTAGGAG	Normal
AAGTACCCAAATCCCA	Tumor
CCGCAAGCATGTTCAG	Normal
AACCAACCAGGAATCG	Normal
TACTTACTCATAGCAC	Tumor
TTCCAATTCTTAAGGC	Tumor
CGAAGGATCCTAGCCT	Tumor
GACACGCGTAGACGGT	Tumor
GACATCATCACACCCT	Tumor
GGTCTGGAGTTGGCTT	Normal
AGGAAATAGACATATG	Tumor
GAGGGTAAGAATAGTC	Tumor
CACTAAGCACAGCCAC	Normal
CTCCCAATCGATAACC	Tumor
AGAAGTATCAGCCCAG	Tumor
GACAGCCGTCCAGCAC	Tumor
TTGTTGTGTCTAGGCC	Tumor
AATGACCTCCTTATGT	Tumor
CTTACCGCACGGCACT	Tumor
TTACGCCAGCTCCACG	Normal
GTAAGTCAGACCAAGC	Tumor
CGAATTGAGAGAACCC	Tumor
TACCTGCCAGGACTAG	Tumor
AGAGAATCAATTCACG	Tumor
ATTCGTTAGTCGTCTA	Tumor
ATGTCCCGTGTCCACG	Tumor
CTACTATCAGTTCCAA	Tumor
TCATCATGTTCTCTAT	Tumor
GTAACCATCGCCCAGA	Tumor
GGACGTCTCCCTTTGG	Tumor
TTTACCAGTCTCACGG	Tumor
TTAATCCTCGTCGCTT	Normal
TACGCTCCAGGACGAT	Tumor
ATGCATGCAATACGAA	Normal
CATACCCGTCAAAGAT	Normal
TTTCAGTAGTGACCTT	Normal
TGACAGTAGAGTAACT	Tumor
GTAGTACAGGAGCTGT	Tumor
TTGCATTGTACCCAGC	Tumor
CTCCATGTCGATTCCC	Tumor
GTTACCCAGGAACTAT	Tumor
GATCAGTAGGTTCAGG	Normal
AACCACAAGTATGCAA	Tumor
TTCCTCTGTCCAATCA	Tumor
AGGATCTGTGATACTC	Tumor
CTCTCGATCGACATTG	Normal
CAGCCAGGTTTACTTC	Tumor
TAGATCGTCCATCTAT	Tumor
TGAGTCACAGAACTCT	Normal
TGAATCGGTATCGCTA	Tumor
CGAGAAGGTGCAACAG	Tumor
GAATCGTCACCCTATC	Tumor
AATCGACTCTAGTGAC	Tumor
AACACACCAATTGAAG	Tumor
GAGATGGAGTATTGCC	Tumor
ATCATTCTCATATGGC	Tumor
GGGTGTCAGACATAAC	Normal
AGGTCATCACAAATCC	Normal
AATCGACCAGCGATTT	Tumor
TCAGGGCGTAGGACTG	Tumor
CAGGTATAGGTATCTC	Tumor
CATGCCTCAGAACTTC	Normal
GGCGTCAGTGGTGATG	Normal
CCTCACAAGTACTCGT	Tumor
CCTCATGAGGATCATA	Tumor
AGAAGTATCACACGAT	Tumor
TCGTCCATCGAATGCT	Tumor
TCAATTCTCATCCTAT	Normal
GCAACCGAGCATATGA	Tumor
TTCCGTGGTGAGCTCC	Tumor
TGGGAAGAGTCTGGTT	Tumor
CATGCAAAGTGCTCAT	Tumor
ATTCCATCAATCAGCT	Normal
ATAGACCTCCGATAAC	Tumor
GTTGAACGTATCCTTT	Tumor
GACCAATGTCTACGTA	Tumor
CAGCAATCACCAGTTA	Tumor
AATTCCTTCTGGGCAC	Tumor
TCACTATTCCTGCCAT	Tumor
CTGCGAGAGGCCACTC	Tumor
TTCTTCCTCAACCTCC	Tumor
CTAGGTAAGGTTTACC	Normal
TACCTGCAGACCATTC	Tumor
ATCACGATCAGTCATG	Tumor
TTGACCCCACGGAAGT	Normal
TGCGATAAGGCTTAGG	Tumor
CTGAGGCGTAGGAGTC	Normal
TCAAGACAGCTCGAAG	Tumor
TGATCAGAGCCATTTG	Tumor
GTGCAGCTCAAATGCC	Normal
GCCATGGAGATTCGCT	Tumor
CCGATGGCAACCCTCT	Tumor
AGCTCAATCCTCATAT	Normal
GTACAGTCATTCGGGC	Tumor
TGGTAGTCAAATACGA	Tumor
CTGTACCTCACTAGCA	Tumor
TGCTGAAAGGATAATC	Tumor
CCTGCATGTGGAAATT	Tumor
GTACAGTCAAACGAGC	Normal
CAAGCTAAGGCACTAG	Tumor
CAGTTCCCAGACCGCT	Normal
AGAACCTTCCGCAGTG	Tumor
CTCTGGTTCACACCCT	Tumor
ACATTTCGTAGGCTCC	Tumor
CGAGAAGTCGTCAACA	Normal
TGGGAAGTCTGGCCGA	Tumor
TCCGAAAAGTACAGAT	Normal
GGCACGTCAAGTGGTG	Tumor
ATTGTTCAGGATTCAA	Tumor
TGCGACGCAATCTCGA	Tumor
TAACACGCATACCACA	Tumor
GCTCAAAGTAGACGGT	Normal
CCAAGCGGTAATGTGA	Tumor
CACCGTTAGGTATTGA	Tumor
TACGCTCTCTATACGG	Normal
ACGTCCTAGAGGATCC	Normal
GGTAACTAGTCTTGGT	Tumor
CGTGATATCATTACTC	Tumor
TGAATCGAGGGAGGGT	Normal
CTCCAACCACCAGTAT	Tumor
ACGTAACGTAACTAAG	Tumor
CGATCGGCATTGACTG	Tumor
CTATAGGGTCGCATGC	Tumor
TCGGGCAAGATTCGCT	Normal
AGAGCCCAGTTTAGGA	Tumor
TTAGGCATCTCCGCAT	Tumor
AGTACTGCACCTCAGG	Normal
AGAAGTAAGACTTCCA	Tumor
GTTGCGGCATCAGCGC	Tumor
CACTAAGAGCTCCACG	Tumor
CTTCAATCAGAGAATT	Normal
ATGAGGGCAGAGTTCT	Tumor
GTAACCAGTGGCATCC	Tumor
GTCAAACTCCAGTGTA	Tumor
AGGGCTCCAATCGCGC	Tumor
TGCGGGTTCACAATGC	Tumor
TGCAGATAGTCTCGTA	Normal
GTAATCGAGGTTCCAT	Tumor
GTTACCCCACCTGCGA	Tumor
TATCTTGTCTATGCCC	Tumor
ATTTACCGTGCTTCAA	Tumor
GAGTCTACACCACATA	Normal
CAATACGGTTGGACCC	Normal
CGGAGAAAGTAGGATT	Tumor
GTCATCCAGCTGTTAC	Normal
ATCGCCTGTCTAACGT	Tumor
TCCTTTCTCCAGTTCC	Normal
ACGGAAGGTGTGACCC	Normal
ATCCACCAGCGTGTTT	Tumor
GCACTAAGTATGTCCA	Tumor
TTCTTCCAGCGCCCAT	Normal
GTCAAACGTTGCCAAT	Normal
TTGCCTGGTCCCTGTT	Normal
GATTTCTTCCTAACAG	Tumor
ACCACAACACTGGCGT	Tumor
GTTGCGGTCCTCAGGG	Tumor
CGAGTTAGTAGGGTAC	Tumor
CCCAACTTCTACCCAC	Tumor
CGAGAAGAGTAGATCA	Tumor
GACTTCCCAAGAGAGA	Tumor
CTTCCTTCAAGGCCTC	Normal
GCCAACGGTCCAGCGT	Normal
GTCTTTAGTTGCATCA	Normal
GCGTTTCAGTAGTCTC	Normal
TCTAACTAGTTCATGC	Tumor
CTGGCAGCAAACGGCA	Tumor
CATGCTCTCTCTATAC	Tumor
GGAAGTGCACAAGCTT	Tumor
CACTGGGAGACCTTTG	Tumor
GATTTCTGTGATTCTG	Tumor
TCATTGTGTACGTGAG	Normal
CTGAGGCGTGGAAATT	Tumor
CGGAATTCACGGGTAA	Tumor
CATCGCTTCCTCCACA	Normal
TTTGACTAGGTGCATG	Normal
TATTCCATCCCGTTGT	Normal
AGCCAATCAAGCCCAC	Tumor
TACACCCTCTCCTGTG	Tumor
ATCGTCCTCGAGTCCG	Tumor
TACCCGTTCGTCCTCA	Tumor
GATCACAGTCTGTAAC	Normal
ATAGACCAGGATTTCC	Tumor
AGTTAGCTCTGTCGCT	Normal
ATCGGATGTAAGTTGA	Tumor
GATCATGAGCAAATCA	Normal
GCATCGGTCACCGGGT	Tumor
ATAGAGACAGAACCGA	Tumor
AACAGGGCAGCCGTCA	Normal
TGGAGAGAGTACCATC	Normal
TCTTTGACATATAGCC	Normal
GCACATACACGTCATA	Tumor
TCATATCAGTAGTCTC	Normal
GCCAGCACACCTTCCA	Normal
CGACAGCAGGCAGTCA	Tumor
TAACCAGTCCGCGAGT	Normal
AGTGATCAGATGGTAT	Normal
TCCTTCTCACACTTAG	Tumor
GTTCATTAGGTCATCT	Normal
TCGCTCAAGCCAACCC	Tumor
TGAGGTTCAATCTGCA	Normal
TCAGTTTTCTTCCACG	Tumor
AGCGCCACACGCGCAT	Tumor
CCTGCATTCCGTAGGC	Tumor
TTGAACGGTCCGATCG	Tumor
GGTGTCGTCTTAAGGC	Tumor
CTCCCAATCTCTCTTC	Tumor
AAGCCATCAGGTTCGC	Tumor
TCACACCTCTTGCAAG	Normal
AACTTCTGTACTCGAT	Normal
ATCCACCTCGGTCGGT	Tumor
TTGGGCGCACTCCTTG	Tumor
CTTACCGTCTCGGGAC	Tumor
GTTTACTGTCTGTTAG	Normal
CAGCACGCAATTTCTC	Tumor
TCCTTTCTCCATTTAC	Tumor
GAGCTGCTCACTCACC	Tumor
TATGTTCCAAGTAGTA	Tumor
CACACAACAACGAGGT	Tumor
CCACCATCAGATCCAT	Tumor
AACGAAACAGACCCGT	Normal
CTCAGGGCAGCCTATA	Normal
CCGAACGTCCGGGACT	Normal
TGGGCTGAGATTCGCT	Tumor
TTTCATGGTTTGAAAG	Normal
CTCTCAGTCTGCCCTA	Normal
ACTTCGCCAACTACGT	Tumor
TCAAGACAGGACTTCT	Normal
AGCTACACATCGATCA	Normal
AGACCCGAGAATCCCT	Tumor
CCTATCGAGGAAGTGA	Tumor
TACAGGTCAAAGGTTA	Tumor
GATTTCTAGTGCACAG	Tumor
AACGAAAAGTGATAGT	Tumor
TTTACTGCAACAAGTA	Normal
GCCAGCATCCACAAGT	Tumor
TGGAGAGCAGCAGGAT	Tumor
CTGTGAACAGCTTTCC	Normal
CCAATGACAGCCCACA	Tumor
TCACTCGCATTCAGCA	Normal
TTTACTGCACATAACC	Normal
CATCAAGAGGTTTACC	Tumor
GATGACTTCCAAAGGG	Tumor
CTGTGAATCGTTATCT	Normal
CTACCTGTCATCTGTT	Tumor
TCACACCAGGATTACA	Normal
CAGCGTGGTTGGGCCT	Tumor
TGACGCGGTTCAAACC	Tumor
GCTTTCGCAAGCGCAA	Normal
ACGCACGCATTCGGGC	Tumor
GTCTGTCAGACTCTAC	Normal
ACTACGATCCTCTCTT	Tumor
CATCCGTTCATTACCT	Normal
GAAACCTTCATACAGC	Tumor
ATCTTCAGTCCTATAG	Tumor
GTGCTGGTCATCGCAA	Tumor
ATCGGATCATTCACCC	Tumor
ATCATTCTCTGGGTCG	Normal
ATCATTCCACTCCGAG	Tumor
AACCACACACAGTACT	Tumor
TATATCCGTGACTCTA	Tumor
TGTTCATAGGCTAACG	Normal
CAGCACGCAAGTGGCA	Tumor
TTCAATCTCCCTTTGG	Tumor
CAGCGTGAGCTGTACT	Tumor
TCATTCAGTTAACAGA	Normal
TACCCGTTCTAATTCC	Tumor
TCCGAAATCCTGTAAG	Tumor
ACTATTCCAACGCATT	Tumor
GGTGATTTCATTTGGG	Tumor
AAAGGGCCAAGCACCC	Tumor
TCTCACGCAGGGTCTC	Normal
CTCCACATCGCAAGAG	Tumor
GTGGGAAAGGTTCATC	Normal
CCCTGATAGGTGCTTT	Normal
GCCTGTTGTACTGGGA	Normal
TCATGAGCATAAGCAA	Tumor
ATCCATTTCCGCACTT	Tumor
TCATCATAGTTTGAGA	Tumor
GAGACCCAGGGAGGTG	Tumor
GGGCTACGTGTTGAGG	Normal
CTACCTGGTGTGTCCG	Tumor
ACTGCAAGTCTCTCTG	Tumor
ACTTCCGAGTCAGCGA	Tumor
AGGACTTGTGCGACAA	Tumor
TCGCAGGCACCTGAAT	Normal
CAGGGCTGTCGGTAAG	Tumor
TTATTGCCAGCGTAGA	Tumor
AGGCATTGTCGAACAG	Tumor
CCGGTAGAGATTCGCT	Normal
CACTAAGAGGTTCCGC	Normal
AGCGCCAAGTTGTAGA	Tumor
AACGAAAAGTCGCCAC	Tumor
GGGTGTCAGCGTTCCG	Tumor
CCTCTAGAGACCAAAT	Normal
GTTGCTCTCACACGAT	Normal
GTAGAAACACGACGAA	Tumor
ACATTTCCACATTCTT	Tumor
TGCGACGAGGCCCACT	Normal
AATGCCAGTGGAATGC	Tumor
AGCCACGCAAGGTCTT	Tumor
CCTCCTCTCCGTGGGT	Tumor
CAATGACAGAGATTCA	Normal
CATACTTAGTCGCGAA	Tumor
TCCTTTCCATAGTCAC	Normal
TAGCACATCCACGTCT	Tumor
GATCCCTGTGAGGCAT	Normal
TTGATGGAGCAGATAT	Normal
CTACTATAGTACGAGC	Tumor
CTCAGGGGTGGTCCGT	Normal
TCATTTGGTCATGCAT	Tumor
CCGTAGGTCCGATAGT	Tumor
AATGGCTAGGCGACAT	Normal
ATTTCTGTCTTGGTGA	Tumor
GATGACTAGTCCCTAA	Tumor
TGCTCCACAGTGACCC	Tumor
GTTTGGAGTCCAATCA	Tumor
AACAAAGTCCCACAGG	Tumor
CGGGTCACAAGCACCC	Normal
TTCCTAAAGAAATGGG	Tumor
TGGTACATCCAGTGTA	Tumor
AAACGAAGTAATTAGG	Tumor
ACTCCCACATAGGTTC	Tumor
TCAAGACGTCAAGTTC	Normal
GTAACACGTCACGACC	Normal
CACTGGGGTATGAAAC	Tumor
ATCACAGAGAAGCTCG	Normal
CAGCGTGAGTATTCCG	Tumor
GAACTGTAGGCCTGCT	Tumor
GTAGAGGCATGCTGCG	Tumor
TCGGGTGTCAACTCTT	Tumor
GGGAAGTGTATCTTCT	Normal
CACAGATAGAGAGGTA	Tumor
TTTACTGAGTCGTTAC	Tumor
ATTCCCGAGTGGAATT	Tumor
GCTGAATCATATGGCT	Normal
CTCCGATGTAGCTAAA	Tumor
AGGTGTTAGTTCACTG	Tumor
TGTACAGTCTTACCGC	Tumor
ACCCTTGTCGGTCTGG	Tumor
TGTCCACCAATCTCGA	Tumor
TCTTTGATCACTACTT	Tumor
TTACAGGTCCATATGG	Normal
GACATCAAGTGAGCCA	Tumor
CTTCCGACAACGGGTA	Tumor
CAGCGTGGTGGTCTTA	Tumor
AAACGAACATAACCCA	Normal
ACCAACAAGCCTGAAG	Normal
GCTTCACAGATGGGCT	Tumor
GAGGCCTTCCCATGGG	Tumor
GATCCCTGTGGCTAGA	Tumor
CAGAGCCGTTACCCTC	Tumor
TTCCAATCAGATACCT	Tumor
TCATTGTTCCATTTGT	Tumor
TTGCCTGCAGTGCGCT	Tumor
GATAGCTAGTGAGTTA	Tumor
CCGGGTATCTGTCGCT	Normal
AATCACGCACTATGTG	Tumor
CTATCTAAGCGGGTTA	Tumor
GGTGATTTCCAAATGC	Tumor
AGGTGTTTCCGGTAAT	Tumor
GAGAGGTGTAAGACCG	Tumor
AGGCTGCGTACCTTCC	Tumor
GTTTACTAGGACAGTC	Tumor
CTGTAGACACATCATG	Tumor
GACTCAAGTTGCTCAA	Tumor
CAGTGCGCAGGAGGAG	Tumor
ACTTATCCATGACAAA	Normal
TGCGGCACAAGGGCAT	Tumor
TAAGCACCAGGACAGT	Normal
GGGTCTGAGTTGAAAC	Normal
GCAGCTGGTGAGTAGC	Tumor
AGCGTATCAAACGGCA	Tumor
GGACGTCCATAGAGGC	Tumor
TGTAAGCAGAGCTTTC	Tumor
TATCAGGTCAGCCTCT	Tumor
AGGGTGACACTGGCCA	Tumor
AACGAAATCGCCTCTA	Tumor
GGAGGTAAGTCGAAAT	Tumor
TTCGATTAGCAAGGAA	Tumor
ATTCCATGTCAGGTAG	Tumor
CGTAATGGTTCGTAAC	Tumor
CCTCCTCGTTTACCTT	Tumor
GTTACCCCACTCTAGA	Tumor
GCACATAAGTCACTAC	Tumor
TGCTTCGTCCCGAAAT	Tumor
CTGGACGGTTGCATGT	Tumor
CCTAACCTCAGTGTTG	Tumor
CTCATCGAGAAGTGTT	Normal
AGTGATCCAACCAGAG	Normal
ATGTCCCTCGCAACAT	Normal
CCTAACCAGGGTGAGG	Normal
GCGTGCACAGGCCCTA	Tumor
GTGGAGACAACTGCCG	Tumor
CTTCCTTAGCCTCAGC	Normal
TAGAGTCTCCAAATGC	Tumor
TAAGCCAAGCTGGAGT	Normal
GCGATCGCACAGAAGC	Normal
GTGTTAGTCAAAGGAT	Tumor
CAGAGCCAGCCTCACG	Tumor
TGTCAGAAGTTCCATG	Normal
ACTTTCAGTACCGTCG	Tumor
GAGTCTAGTAGAGACC	Tumor
CTCCAACCAGCTGGTC	Tumor
GGTGTTATCGAACCAT	Normal
GCAGGCTCAGTTCTAG	Normal
TGGATCAAGCTCGAAG	Tumor
CATACAGGTCCTGGTG	Normal
TGGAGGAAGACTTCCA	Tumor
AGTCACAGTGCAATGG	Tumor
AGGAAATAGCCTGAGA	Tumor
TCCACCAGTGACTGAG	Tumor
TGACCCTCACTGAGGA	Tumor
GATCGTAGTCTCGACG	Normal
TTCTCTCTCGAGAGAC	Tumor
GTCGTTCCAAACCGGA	Tumor
GACCCTTCAACGTTAC	Tumor
TTCATTGAGGTAGGCT	Normal
AGGACTTCAGTAGGAC	Tumor
CGAAGGAGTCTAGGTT	Tumor
TGTCCACTCTTTGCGC	Tumor
TCCTAATCATATTCGG	Tumor
CAAAGAATCCCAAGTA	Tumor
TTGGTTTCATGTGCCG	Normal
AAGTCGTCATGTGTCA	Tumor
CAGGGCTTCCCATAAG	Tumor
ATGCCTCGTTCCGCGA	Normal
GTGGGAACACCTGCAG	Tumor
AGTAACCAGACGGTTG	Tumor
ATTATCCTCATGCGGC	Tumor
GCAGGCTCACTCACTC	Tumor
CACTAAGTCCAAGCCG	Tumor
GGGATGACACAGCATT	Tumor
CTCAGGGGTCAGTTTG	Normal
CGTTGGGAGACTGAGC	Tumor
GTAGAAAAGCCATTTG	Normal
AGAACCTGTAGCTGTT	Tumor
ACACAGTTCGTTCCTG	Normal
TGATTTCCAAGTCATC	Normal
TTAGGCATCCAACCGG	Tumor
CTCAATTGTCGTACAT	Normal
TTGCATTAGACATACA	Tumor
AACGGGAAGGATTTAG	Tumor
CTTCTCTCAACCCGCA	Tumor
TCATTACTCTATTCGT	Normal
TGAACGTTCTGAATCG	Tumor
CAGTTCCGTTGGATCT	Tumor
TGGGAGAGTGCGGTAA	Tumor
ATGATCGCATTGAAAG	Tumor
TCAGTCCCATCGATAC	Normal
GTTACCCTCCTTCGAC	Tumor
CTCCACAAGTCAGCGA	Tumor
GCGAGAAAGGAACGAA	Normal
GCTTGGGCAAGGTACG	Tumor
TCACGGGGTCTCAAGT	Tumor
CTCCGATGTTTCGATG	Tumor
GACCTTCTCCATTGTT	Normal
TCAAGCAGTGTCATCA	Tumor
GAGTTTGCAATGCAAA	Tumor
TTGATGGAGGCAGTCA	Tumor
CCTACGTTCACCTTAT	Tumor
TATTCCATCTATCACT	Tumor
TTCAGGACATAATCGC	Normal
CATACTTGTGAATGTA	Normal
GCACTAACACGCGGTT	Normal
ATCCGTCTCATCGTAG	Normal
GCAACATTCGCAATGT	Tumor
CTCAATTAGGTAAAGG	Tumor
CATACTTAGCCTCAGC	Tumor
GGTAACTGTCCAAAGG	Tumor
GTGGAGAGTCAAACGG	Tumor
TCTATCATCACGACTA	Normal
TTGCCTGGTCAGTCTA	Tumor
TCCTAATTCAGCGCGT	Normal
ATCGGATGTGCTAGCC	Normal
GACCTTCAGTTGGACG	Tumor
GACATCAAGATCACTC	Tumor
CATGAGTCAAGAGCTG	Tumor
CCTCTAGTCCGGACTG	Tumor
TGTTCTATCCTGCTAC	Tumor
TTGCTGCGTTAGTCGT	Tumor
GCACTAAGTTAGTTCG	Tumor
TCATTCACACTGGCGT	Normal
TGCCGAGCAGGCATTT	Tumor
AGTGCCGAGTTAACGA	Tumor
CTTCTAATCGTTGTAG	Tumor
GCATCTCCAACGGGTA	Tumor
CACTTCGAGTACAGCG	Normal
GCGGATCAGCACAAAT	Tumor
TTGCTGCTCCATTGGA	Normal
TAAGCCAGTAGGTTTC	Normal
AATGCCAAGAAACCCG	Tumor
CCACAAAGTGTCTCCT	Tumor
CCCAACTGTTTACCTT	Tumor
GTTAGTGGTAAGTTAG	Tumor
AGATAGAGTACGCTTA	Tumor
GACTCAATCCAGTTCC	Tumor
CTCAGTCAGCCTCCAG	Tumor
CTCAATTTCGTCGCTT	Tumor
AACGAAACATAGCACT	Tumor
CACGAATTCACTGGTA	Tumor
CTCTGGTGTTGGTACT	Tumor
CTGCTCAGTACGATGG	Tumor
CCACAAACATGACAAA	Tumor
CAACGATCACCAGCCA	Tumor
TGTGTGAGTTGTCTAG	Tumor
CATAGACTCGCCACTT	Tumor
CCACCATTCAACGCTA	Tumor
GCAACATCAGCCCACA	Tumor
TGATTTCGTGTCTAAC	Tumor
CACGTGGGTGTCCACG	Tumor
AGATGAACACATGGTT	Tumor
CTGTACCTCTAGTGAC	Normal
CGGGACTGTTGGGACA	Tumor
GACCCAGCACACCTGG	Tumor
TGTTACTGTCGCATCG	Normal
ACTTATCGTGCAGTGA	Tumor
AACCCAAAGACCCGCT	Tumor
TCTGCCACACCGCTGA	Normal
AGAAATGGTATCATGC	Tumor
CATTCCGCAATTGCGT	Tumor
ATTCACTGTATGAAGT	Tumor
AGGTCATCAACCCGCA	Tumor
GTGGGAACAAGCCTGC	Normal
TTCCAATCAAGTTTGC	Tumor
TGGTAGTTCGTGGACC	Tumor
CCACGAGAGTGGACTG	Normal
CGATGGCCACCAAATC	Tumor
CGTTCTGGTCACAATC	Tumor
AAACGCTTCACGGGAA	Normal
GATTGGTTCGATTGGT	Tumor
TGAATGCGTACGAAAT	Normal
ACGTAACAGGACGGAG	Tumor
ATCTTCAAGCACCGAA	Tumor
CAAGGGAAGAAATGGG	Tumor
GCGGATCAGTGTACAA	Normal
GCTCAAAGTCATCTAG	Tumor
ATGATCGCAGGATGAC	Normal
CTTCTAAAGCTGCCAC	Tumor
CCACGTTGTCATCAGT	Tumor
ACTTATCTCTGAGCAT	Normal
CCGGACACAACTTGCA	Tumor
TCAGGGCGTGGAGGTT	Tumor
AGAACCTTCTGCTTAT	Tumor
TAATTCCGTTGGGAAC	Tumor
TGGCGTGCACTAGTAC	Tumor
AACAACCTCGTGAGAG	Tumor
CGTTGGGCATACGCAT	Tumor
CTACCCATCAACACGT	Tumor
CTCAACCAGAAGATCT	Normal
GACTCAACAGCGATTT	Tumor
ATTGTTCAGATTGGGC	Normal
CTCCCTCAGGCTTCCG	Normal
ATCTCTAGTCACCGCA	Normal
TTACTGTAGTGTTGTC	Tumor
GGGAAGTCAAATAAGC	Tumor
TCCATCGCACATAACC	Tumor
AGCGCTGTCCTCTGCA	Normal
TTGACCCTCAGCTGAT	Tumor
CCTCAACCAATGCTCA	Normal
AGAGCCCGTAGTCCTA	Tumor
CTTACCGTCATACGAC	Tumor
AATTCCTCACAGTATC	Tumor
GATGGAGGTTTGTGGT	Normal
ACGTTCCTCAATGCAC	Normal
CAAGGGATCGATACTG	Normal
AGAGCAGTCGACCACG	Tumor
GGTGTTATCTAAGGAA	Tumor
ATTCTACTCAGTGTTG	Tumor
CATCCCAAGAAGCTGC	Tumor
ACCCTTGAGTCATCGT	Normal
TGATGGTAGTCTAGCT	Tumor
ATTCAGGGTTGTTGTG	Tumor
TAGGGTTCACTTGGGC	Tumor
TACCTCGGTCACAATC	Tumor
ACGGAAGCAGAAGTGC	Tumor
CTGGACGAGCCTCTCT	Normal
CGGACACGTAACATGA	Normal
ACGTACACACATGTTG	Tumor
CAAGGGAGTGTTTCTT	Tumor
GTTGTCCTCGCTCCTA	Tumor
CCACGTTAGTGGTTAA	Tumor
TGGAGGATCCGATCGG	Tumor
TCACTATCATAGCACT	Tumor
GGGACCTAGTATAACG	Tumor
CCTCATGCATGGGAAC	Tumor
GCTTGGGAGCTATCCA	Normal
ATATCCTAGACTGTTC	Tumor
AATGGAACACTACACA	Tumor
AGGTGTTAGAATCTAG	Tumor
CCATAAGGTGGTAACG	Tumor
ATGACCATCGGAGCAA	Normal
ACACTGAAGAGTACCG	Tumor
GCATTAGAGTCGCCCA	Normal
TACGGTATCATCGCCT	Tumor
TCCCACAGTTAAGACA	Tumor
TCATCCGTCGCTACAA	Normal
AAAGGATGTTCGGCCA	Normal
GGGATGAAGATTCGAA	Normal
ATTCACTTCAATCTTC	Tumor
GTCATCCAGATAGCAT	Normal
AGTGCCGAGTTCCGTA	Tumor
ACGTACAGTCCAACGC	Tumor
CTGCCATCATCGAACT	Tumor
GATGGAGCACTGCTTC	Tumor
CCGTTCATCTAGTTCT	Tumor
CATTCATCACTGGAAG	Tumor
TGTCCCAAGTCATAGA	Normal
TCATTCAGTTATCTTC	Tumor
GACTCAAAGAGATCGC	Tumor
CTCAACCAGGTACCTT	Normal
TCACGCTAGAGGTCAC	Tumor
GATCGTATCACCATAG	Tumor
TAGGGTTGTTCAGCGC	Tumor
GTGCTGGGTTCATCGA	Tumor
TGAATGCAGCGCTGCT	Tumor
GTAATGCAGTGCAGCA	Tumor
GCACGGTCATGTCTAG	Tumor
GTAGCTACAGCAGTTT	Tumor
GGAATGGGTAGGCTGA	Tumor
GGGATCCCACCTTCCA	Normal
GACATCATCATTCGTT	Tumor
CGGGTCAAGGCTGGAT	Tumor
TTTACCACAAACTAAG	Tumor
GTGCACGCACTGTGAT	Tumor
CATTCCGGTCTTACAG	Normal
TACAACGGTACCCACG	Tumor
TGTTCATAGAGCTTTC	Tumor
CCTCAACAGCTAGATA	Tumor
GTGACGCCAAGCGAGT	Normal
ACCCAAATCACGATCA	Tumor
GTTGTAGTCTCGTGAA	Normal
ACAGAAAAGTATGACA	Normal
ATCCTATCAGAGTCAG	Tumor
TGGTAGTGTCTAGTGT	Tumor
GGCTTGGCAGGTTCGC	Tumor
GAACTGTAGCACCGTC	Normal
TCATGGAAGGGAGGAC	Tumor
AAACGAAGTCGAACGA	Tumor
AGTAGTCTCAGCTAGT	Normal
GAGGGATGTTACCGTA	Normal
AGTTAGCGTGCACGCT	Tumor
TAGTGCATCAATCCAG	Tumor
TGAGACTAGCACACCC	Normal
GTCATGACATCATCCC	Tumor
AGGTTGTTCCACTTCG	Tumor
AATAGAGCAAGCAATA	Tumor
CGTCAAAAGGGAGGCA	Tumor
GACCTTCCAGGCTATT	Tumor
TTTGGAGTCGTGCGAC	Tumor
TCATTGTGTTCGTAAC	Tumor
GTGCAGCCAAGACCTT	Tumor
AAAGGGCCATGCGGTC	Tumor
TCACTCGCACTCATAG	Normal
GGTTAACGTGATTCTG	Normal
AAGGTAAGTGGTCTTA	Tumor
CCACGAGCACCGGTCA	Tumor
TTTCACAGTCCGCAGT	Tumor
GCCAACGGTGTATTCG	Tumor
GATCACACACTCCTTG	Tumor
GTCCTCATCCGGCTTT	Tumor
ACGTAGTCACTCTCGT	Normal
CGTGTCTCACACCAGC	Tumor
AATGGAACAAGAAACT	Normal
GACCCTTTCTGCGATA	Normal
TCCTTTCTCTAAGGAA	Tumor
GGTTGTACAACCGACC	Normal
CTGTGGGCACTACCGG	Normal
CAAGGGAGTAGTGATA	Tumor
ACGTAACTCTCGTGGG	Normal
GAGATGGCAGGACATG	Tumor
AACCATGGTCGTCATA	Tumor
CCATCACCACAGTATC	Tumor
TACGGTAAGAGAGCGG	Tumor
CCAAGCGTCCAACTAG	Tumor
CGTCAAAAGGTATCTC	Normal
GTGCAGCAGCTGACCC	Tumor
CTCATGCGTCTGTGGC	Tumor
TTGCTGCAGCACTCTA	Tumor
TTGCGTCCATCGATCA	Tumor
CCCATTGTCCAAGCAT	Normal
CTTACCGTCTATGTGG	Tumor
CCTTCAGAGTATGCAA	Tumor
CAGTTCCAGCAATAAC	Tumor
CAACGGCCAAATGATG	Tumor
ACTGTGAGTGATTCAC	Normal
TGCATCCGTTCTGAGT	Tumor
TTGAACGCACACACGC	Normal
GATCAGTTCGCCACTT	Tumor
GAGAGGTGTGAGCCAA	Tumor
TCGGGTGAGCACTCCG	Normal
AGATGCTGTTGAGTCT	Tumor
CAACGATTCTCAGTCC	Tumor
ACTGTCCCATTCGATG	Tumor
TCTTGCGAGTAATCCC	Tumor
TTCCAATTCTCATGCC	Tumor
TGCTGAACAAATCAGA	Tumor
ATTGGGTCACAGCTTA	Tumor
TAGTGCAGTCCAAAGG	Tumor
TTGTGTTAGATGCTGG	Tumor
CCTAAGATCACCATAG	Tumor
TTACCATTCCGATCGG	Tumor
TATATCCCATGTGTCA	Tumor
CAATCGAAGAGCCATG	Tumor
CCTACGTTCTTAATCC	Normal
TCCGTGTCAGTATTCG	Tumor
CCATCACGTAGGGAGG	Tumor
GCATGATAGTCGCGAA	Normal
TCAAGACAGACTCATC	Tumor
ATGAGGGCAATCGTCA	Normal
CTACAGATCCTGGGTG	Normal
AATGCCATCCATTGCC	Normal
CAATTTCTCCGATAAC	Tumor
GTTTACTAGTAAAGCT	Tumor
TTCGCTGGTAGACTGG	Tumor
GAGGCCTTCAAGAATG	Tumor
GTAAGTCAGGAGAGGC	Tumor
CCTTTGGCATCCTTGC	Tumor
ATTGGGTTCACCTCTG	Normal
TCCACCAGTCTTTCTA	Tumor
ATAGAGACAAGGGTCA	Tumor
AGAGAGCGTACTGACT	Tumor
CACTGAAAGCATCTTG	Tumor
TTAGGCAAGGTACAAT	Tumor
TCTGCCAGTCGTGTTA	Tumor
TGTTACTAGTTGTAAG	Tumor
ATCGGCGCACTACCGG	Normal
ACACTGATCTTCGGAA	Tumor
GACTCAAGTGTAAACA	Tumor
CGCCAGAGTCGTGGTC	Tumor
TTACGTTCAGCGCGTT	Tumor
GCCCGAATCGTGCATA	Normal
AGTCATGCACTACCCT	Normal
ATCACGATCTGGCCGA	Tumor
AAACCCACAAGAGTAT	Tumor
ATCGTAGGTTCTCCTG	Tumor
CAACAGTCAGTGACCC	Tumor
AATGGCTAGAAGCCTG	Normal
CCACAAAAGGGAGGTG	Tumor
TGGAGGACACATGACT	Tumor
CCATAAGCATCTATCT	Tumor
TACCCACAGCTTCGTA	Normal
TGTAAGCGTGATCATC	Tumor
TGTGCGGGTCAACCTA	Tumor
CCTATCGAGCAACAAT	Normal
TTGTTGTGTATCTTCT	Tumor
TTCAATCGTCGGTAAG	Tumor
AGGAGGTAGTAGACAT	Tumor
ATGTCCCCAAAGTGTA	Tumor
GGGTGTCAGTAGTCTC	Tumor
TGTTGAGTCTTACCGC	Normal
TCTAACTTCCATAGAC	Normal
TCATGAGCATAGGTAA	Tumor
TGGATGTAGGGCAATC	Tumor
CTTGAGAGTTGCCAAT	Normal
TGGAGGAAGCCATTTG	Tumor
GCCTGTTGTGAGCCAA	Tumor
ACTGTCCCACTAGGCC	Tumor
TTCCTAAGTACGACTT	Normal
AAGGAATCATGGAACG	Normal
TGATCAGAGTACGAGC	Tumor
TCAATCTCAGAGAATT	Tumor
AGGGTCCTCGCTTGCT	Tumor
CTAAGTGAGGCATTTC	Normal
CATCGCTGTGCCGTAC	Tumor
GGTCACGGTGTATACC	Normal
GTAATGCCATCGGAGA	Tumor
ACAAGCTTCGTTGCCT	Tumor
GTCAAACGTCGAACGA	Normal
AGTCACAAGTCTACCA	Tumor
GAACGTTCACGGGTAA	Tumor
CCACACTAGGATTCAA	Tumor
ATCACGAGTTGCATGT	Tumor
CGATGGCCAGGTGAGT	Tumor
ATGAGGGAGAGGGTCT	Tumor
GAGTGTTCATCGCCTT	Tumor
GTTATGGTCCCAGCGA	Tumor
TTGTTTGCACTCTGCT	Tumor
GAATCACAGTTGCTGT	Tumor
TCATACTCAGTATTCG	Normal
CTGTGAACACCCGTAG	Normal
GTAGATCCATGGCTAT	Tumor
GACTGATGTGCTGATT	Tumor
CGTGAATGTTTACCAG	Tumor
GCGGAAACACTGCGAC	Normal
TGAGGAGGTGCATACT	Tumor
CTATCCGTCCTCGCAT	Tumor
TCACACCAGGTCACCC	Normal
AAGCGAGCAAGATCCT	Normal
CATCCCATCTGGGCGT	Tumor
ATCATTCCATAGATGA	Tumor
TTAATCCTCTCGAACA	Tumor
CATTCATGTCTATGAC	Tumor
GTGGAAGGTCAGCTTA	Normal
AGCGATTAGGTAAACT	Tumor
AAACGAAGTCACAGTT	Normal
CGTGAATAGGTATTGA	Tumor
GTGCTGGGTACACGTT	Tumor
GAGGCAAGTGCGGATA	Tumor
ATTATCCGTTCCAAAC	Tumor
TCATTCATCAAGTTGC	Normal
ATCCGTCAGGTGCTGA	Normal
GAGAGGTCAGGAAGTC	Tumor
CTGCATCTCCTCGATC	Normal
TACAACGGTCAAACGG	Tumor
AGGTAGGTCGAAATCC	Tumor
CGGCAGTAGTGTCATC	Normal
GTAACACTCACTGGTA	Tumor
CAGTTAGCAAAGGATT	Tumor
GACCCAGGTTTGTTGG	Tumor
CCTCATGTCATGCCCT	Tumor
GCGTTTCCAGCTACCG	Tumor
ATCGATGTCCATAGGT	Normal
TGGAGAGAGTGATAGT	Normal
AGTGCCGCATCCGAGC	Tumor
TCACACCTCACCGGTG	Tumor
CAATACGTCCAACCAA	Normal
TTTGGTTGTGGTAATA	Tumor
TCCATGCGTATCACCA	Tumor
GACACGCGTGGCCTCA	Tumor
AGGGCCTGTCACCTTC	Normal
CGATGCGTCTTTACAC	Tumor
AGAACAACAATAACCC	Tumor
ACTGTGAAGAGTATAC	Normal
GCATCGGGTCGCATTA	Normal
ATGATCGGTATAGGAT	Tumor
TTGACCCAGTAGACCG	Normal
ATTTACCAGTAGACAT	Tumor
CACGTTCCATTGTGCA	Tumor
CAACCTCGTCTGTGCG	Normal
GTAGAAACACGGCTAC	Tumor
CTTCCGAAGCGTTGTT	Tumor
GTGGAGAAGGCACCAA	Tumor
GGGTTATTCTTGGTCC	Normal
TACGCTCCATGTCGTA	Tumor
TGAGGAGTCGTAGCTA	Tumor
TTACGTTGTACTCGAT	Tumor
GGGTAGAAGCCTCTTC	Tumor
AGGAGGTCAAGTTCGT	Tumor
TCAATCTTCAAGGCTT	Normal
TCACAAGGTACGATTC	Tumor
TCAAGTGCAGTCGAGA	Normal
GCTTCACGTAGGTTTC	Tumor
TGACCCTGTTAGTTCG	Tumor
CTACTATCAAGCACAG	Normal
GTTTACTAGTGGAAAG	Tumor
ACCTACCGTTGTGTTG	Normal
AGAAGTAGTATAATGG	Normal
GTATTGGTCAGCTGTA	Normal
TGCTCCAAGTACTGTC	Normal
CGTGATAGTCCGTTTC	Normal
CTGTCGTTCTTCTTCC	Tumor
TTCCGTGGTCATCGCG	Normal
TCACTATAGAAATTCG	Normal
TTCTAACAGTCGCTAT	Tumor
TACGTCCTCTTGCAGA	Tumor
TCCCAGTTCGCTGATA	Tumor
CCGGTGAGTGGCAGAT	Tumor
TCCTAATCAACAGCCC	Normal
CACTGAACACAGTCGC	Tumor
TCACAAGCAAATCGGG	Tumor
GAACACTCATTCTCCG	Tumor
GACACGCAGTCCGCCA	Tumor
CAGCGTGTCATCTGTT	Tumor
AACCAACGTCCCGCAA	Normal
CCGAACGTCGGTGCAC	Normal
TGGAGGAGTTCTCCTG	Tumor
AACCACACATAGAGGC	Normal
ACTCTCGCATAACCCA	Tumor
AGATAGATCTCAAAGC	Tumor
CTCCACAAGCTGAAAT	Tumor
AGCGCTGCACCAGACC	Tumor
CGTAAGTAGTATTCCG	Tumor
GTCAAGTTCCTGTACC	Tumor
ACATCCCGTGTCATTG	Tumor
TTCCTCTAGCTATCCA	Tumor
ATTCCATTCTGTTGGA	Tumor
AAGAACAAGTATTGCC	Tumor
TGCAGTATCTGGTCAA	Tumor
TTCATGTCACCGAATT	Tumor
GGATCTACATACCGTA	Normal
ACCCTCAAGTCGGGAT	Tumor
GAGAGGTGTCTGCCTT	Tumor
AGAAATGGTCGTATTG	Tumor
CGATCGGGTGCTAGCC	Normal
GACACGCAGTGCACCC	Normal
ACTTTGTAGACAAGCC	Tumor
TCATCCGGTGCACGCT	Normal
CACGGGTTCCACGGAC	Tumor
GAGGGTAGTACGTTCA	Normal
GGTAATCTCCTGCTAC	Tumor
TGATGGTAGGTGATAT	Normal
CTGGCAGGTGTCGCTG	Tumor
CCTACGTCAATACCTG	Tumor
TCACGCTTCCCATTTA	Tumor
TGGTTAGGTCTCAAGT	Normal
CAGGGCTGTTATCTTC	Tumor
TGGAGGAAGGTTCCGC	Tumor
TATCTGTTCTTTGGAG	Tumor
AGATCCAGTACCTGTA	Normal
TTTACTGCAAGTGGTG	Tumor
GACGTTAGTTTCCCAC	Tumor
TCTCACGTCTACGCGG	Tumor
AACAAAGAGATGGCGT	Normal
GATAGCTAGTACAACA	Tumor
AAGTTCGAGGCATCGA	Tumor
TGAGACTTCTCCAAGA	Tumor
TTTGATCTCTTCGTAT	Normal
TACGGTACACTGTCGG	Tumor
AAAGGATGTCTACATG	Tumor
TTTGTTGTCACCTGGG	Tumor
ACGATGTCAGCGTTTA	Tumor
CATTGTTGTCTTGCGG	Tumor
AACACACGTGGATCAG	Tumor
AACCTTTCAACTCGTA	Tumor
TATATCCGTAAGATCA	Tumor
GTGGGAATCTCGTGAA	Normal
GCCATGGCACTCACTC	Tumor
CGAGGCTTCGGAGCAA	Tumor
CCTTTGGCATGTGCTA	Tumor
CTCCAACGTTTCCAAG	Tumor
TACTTCACAGTAGAGC	Tumor
GCACGTGCATCCTTCG	Normal
CTCAATTCAGTGACCC	Normal
TCTCCGACAGTTGCGC	Tumor
TGTTACTCACATATGC	Tumor
CCGGGTATCGCACGGT	Normal
AATCGACAGTGAGGTC	Tumor
GGTAACTAGGGCGAGA	Normal
GGTTCTCGTACGTGAG	Tumor
TCCTTCTAGGAGATAG	Normal
CTAACCCCAAGGGCAT	Tumor
TGTTCATAGTTACGGG	Tumor
CAGTTCCTCTTACCGC	Normal
TGGATGTCACTCCACT	Normal
TAGAGTCTCGTCTAAG	Tumor
GCTGAATAGCGTGTCC	Tumor
CCGGGTAAGATAACAC	Tumor
AGAGAGCAGCTCGGCT	Tumor
CTAGGTATCTCCCATG	Tumor
GTGCTTCTCCGCACGA	Tumor
GAATCGTAGTAGGGTC	Tumor
CATTGTTAGTGCGTCC	Normal
AGCGCTGTCTGCGGAC	Tumor
TCGGGCATCGTAACAC	Tumor
AGACAGGAGACGGTTG	Normal
TGTCAGAGTCTTCAAG	Normal
GACTCTCCACTGCTTC	Tumor
TTGGATGAGCTCAGAG	Normal
CAACCAAAGGAACTCG	Tumor
AGCGTATCAAGTGCAG	Tumor
TGATTTCTCCGTGTCT	Normal
CACAGATTCGTCAAAC	Tumor
AGAGAATGTATCCTTT	Tumor
CTGGACGTCGGTCATA	Tumor
TTCCTAATCACCCATC	Tumor
GAGCTGCAGTAGAATC	Tumor
TCTTAGTCAATATCCG	Normal
ACTACGAAGCGGGTAT	Tumor
GTGGAGATCAGTGGGA	Tumor
AGCGCTGTCAGCAGAG	Tumor
CAACAGTTCCTGGGAC	Tumor
TTCGGTCCACGGGCTT	Tumor
TAGACTGAGTCATAGA	Tumor
AGAAGCGCAACAGCCC	Normal
GGTGTCGTCACGATAC	Normal
TTCATTGTCAGACCGC	Normal
GCCAGGTGTCAGACGA	Normal
AATCGTGAGTTGTAGA	Normal
TGGATCAAGGTGCTTT	Tumor
TTCCGGTCATTCCTAT	Normal
ACATCGAAGACGAGCT	Tumor
GACGTTAGTCCGAAAG	Normal
CATGCGGAGACGTCGA	Tumor
ACACTGACAACTTGCA	Normal
ATCAGGTCACAATTCG	Normal
CGTAATGGTAACGCGA	Tumor
ACAAGCTAGGGCATGT	Tumor
AGGTGTTTCTCATTTG	Tumor
GGGTATTTCTATCGGA	Tumor
ATTCTACGTTAGGGAC	Normal
GCAGCTGAGGTCATCT	Normal
GTCATGAAGATCACCT	Tumor
ACTTTGTCATCCTTCG	Tumor
GACCTTCAGCACTCAT	Normal
GTCTGTCAGCATATGA	Tumor
TCTGTCGTCATCCTGC	Tumor
TGTAACGTCACCATGA	Tumor
AGGGTTTGTGAGCCAA	Normal
GTAGGTTAGATTAGTG	Tumor
GTGTGGCTCTTGGTGA	Normal
ATGGGTTGTTAAACAG	Normal
GGGCCATCAATCTAGC	Tumor
TGAGCGCCACCCTTGT	Tumor
TTAGGGTGTAGATTGA	Tumor
GTTGTGATCTTGGTCC	Normal
CACTTCGCAACACGAG	Tumor
TGGATCAAGCATTGTC	Tumor
TTCCGTGGTTGTGTTG	Tumor
CCTTTGGAGACCATAA	Tumor
CTATCCGTCGGTGTTA	Normal
AATCGACTCATGCGGC	Tumor
AGGTGTTTCGACGAGA	Normal
GCCTGTTAGCATTGTC	Tumor
TCACGCTTCGGTCTGG	Tumor
CAAAGAAAGTGTTCCA	Tumor
AGGCATTTCTGAGTCA	Normal
GGTGATTCATGCCGGT	Tumor
TGGAGGAGTCGTCTCT	Tumor
AGAACCTTCGCGTGCA	Normal
CTGAATGGTCAGCGTC	Tumor
CATTTCAGTTAGAAAC	Tumor
TGAACGTTCCAACCAA	Normal
TACTTGTTCCGCAACG	Tumor
GGTAACTAGAATACAC	Normal
TGCGGCAAGCGCCTTG	Normal
GATGAGGGTCTAACTG	Tumor
TTGAGTGAGCGGACAT	Tumor
TTTCATGCATGATGCT	Tumor
TCCGGGAAGCGGTAAC	Tumor
CGTTAGATCATGCATG	Tumor
GGCTGTGGTGCTCGTG	Tumor
GTGGTTAAGCTGTTAC	Normal
TGTTCATGTGTCTTGA	Tumor
ACTCTCGAGTCTACCA	Normal
ATCGTAGCATGTGGTT	Normal
TCTCTGGAGGCCACTC	Tumor
ATACTTCAGGACTGGT	Tumor
TCATTCAGTTGAGGAC	Tumor
GTCATTTTCTAGGCAT	Tumor
GTAGAGGAGGTAGATT	Tumor
TGCGGCATCCAAGAGG	Tumor
GCCCGAATCCGCCTAT	Tumor
CAAGAGGAGTAAAGCT	Tumor
GCCAGGTCAGTTCTAG	Normal
ACCACAAAGCGTTGTT	Normal
AGAGCCCGTCAAACGG	Tumor
TATCTGTCAGAGATTA	Normal
GACTATGAGGGAGTTC	Tumor
AACCCAAGTAAGTTGA	Normal
TCCCAGTTCTGTGTGA	Tumor
TAACACGGTCTCTCCA	Tumor
GTTGCTCGTACCGTGC	Tumor
TCGGATACATGACGAG	Tumor
AAGCGAGCAACTTGCA	Tumor
CTTCTAAAGCGCTGAA	Tumor
CGCAGGTGTAGCGTTT	Tumor
TCGCTCAGTGTGCTTA	Tumor
TGCTGAATCACTTGGA	Normal
CGTTGGGTCTGGCTGG	Tumor
ATTCCTAGTGCCCGTA	Tumor
AGATAGACATCCGAAT	Tumor
TGCACGGCAGTGCCTG	Tumor
AACCATGTCAAGTCGT	Tumor
AAGCATCCACACACTA	Normal
TAAGCGTCAAGATGTA	Tumor
TCCTGCATCAGACCTA	Tumor
GAGCTGCCATGAATCC	Tumor
GACCTTCCACAAAGTA	Tumor
TTCATGTCAGACCAGA	Tumor
CTGTACCCATCCGGTG	Tumor
AGACCCGAGAAGCGGG	Tumor
CACAGGCGTCCGTACG	Normal
TTTATGCGTACGATCT	Normal
TTCTCTCGTCCGTACG	Tumor
CTGCATCGTAACAAGT	Normal
GAGACCCCATCCCACT	Normal
GTCAAGTCAAATCCCA	Tumor
AAGGAATCACGTATAC	Tumor
GTAATGCGTGAGACGT	Normal
AATGACCTCATCGCAA	Tumor
GCTCAAACAAGTTTGC	Normal
GCATGATGTTCGGCCA	Normal
TTGTTTGAGTAATACG	Tumor
GTCACGGCACTAACCA	Normal
GATGATCAGGTTCACT	Tumor
CACAACACAAGTCCCG	Tumor
ACCTACCCAGCGCTTG	Tumor
TAAGCCAGTCACTAGT	Normal
GACGTTAGTGTTCGAT	Normal
TGGATGTCATCAGCGC	Tumor
CCGCAAGGTATCATGC	Tumor
CCAAGCGCACGAGAAC	Normal
ATGACCATCGATACAC	Normal
TAATTCCGTAATCAAG	Normal
GTCAAACTCTTACCAT	Normal
GGGTTATGTCGAGCTC	Tumor
GAGCCTGTCTTGGTCC	Tumor
TCTTAGTGTCTAGTGT	Tumor
GACTCTCCAGTCGTTA	Tumor
TCGGGCACACGCTGAC	Tumor
TTTACTGGTTCTGAGT	Tumor
GGTGATTAGTGCTAGG	Normal
CGTAGTAAGAGGCCAT	Tumor
CGCCAGATCCGAACGC	Normal
ATCGTCCCACACGGAA	Normal
CATGGATAGCCAAGCA	Normal
AGTGCCGAGTCCCAAT	Tumor
AGCTCAACAAATGATG	Tumor
CAGTTAGCATCAACCA	Tumor
TGTAAGCCATAGCACT	Normal
CGTAATGCAATTAGGA	Tumor
CTAACTTCAACAAAGT	Normal
ACCGTTCAGGTAATCA	Normal
GCAACCGGTTGAATCC	Normal
GATGGAGTCATCGTAG	Tumor
CTCCTCCCAGTAGAGC	Tumor
AGTAGTCAGATGCTTC	Tumor
AAGAACAGTGGGCTTC	Tumor
CACGAATCAAGCTGCC	Normal
TTATTGCAGATTCGCT	Tumor
TGGATCATCCCGGTAG	Normal
CCTGTTGAGTCACAGG	Normal
GGCTGTGCATCGGAAG	Tumor
GTGAGGAGTATGCTAC	Tumor
CCGGGTACAGTCAGTT	Tumor
TTGCGTCAGTTCCATG	Tumor
ATCCGTCGTCCTGGGT	Tumor
GAGTTTGTCTTGGGCG	Normal
CTGCCATAGTAGGAAG	Tumor
GATTTCTAGGGCAAGG	Tumor
TGTGTGAAGTAAGAGG	Normal
TTCACCGGTCTGCATA	Tumor
GGCTTTCGTCGTTCAA	Tumor
GTGCAGCCAGGTCAAG	Normal
AATTTCCTCGCAGTGC	Tumor
GTAGGAGGTTCACGAT	Tumor
CCGGACATCGATTGGT	Normal
AGAAATGTCCCAGTGG	Normal
TGTCAGAAGCACTAAA	Tumor
TCTTCCTGTCCCGTGA	Normal
CATGCGGTCCGTCACT	Normal
CTACGGGCAGTCTACA	Tumor
AGGAGGTGTCATCAGT	Tumor
GTCTCACCACGACTAT	Tumor
AAGTACCAGGCGTCCT	Tumor
GTTATGGGTGTAGTGG	Tumor
TCATGGACAAGCGCTC	Normal
AGGGCCTTCTTAGGAC	Normal
CCTATCGGTTGTGCAT	Tumor
TTCATGTTCCAATGCA	Normal
TCCGATCCAGTCTTCC	Normal
GAATCACAGGTAGGCT	Normal
ACGATGTAGATGGCGT	Normal
CCGGACACACCCTAAA	Tumor
CTTCGGTAGATGGTCG	Tumor
CACTGTCAGTGGACTG	Tumor
TGAGGAGTCATAGACC	Tumor
TTTGGTTAGCTCGGCT	Normal
ATGGATCCAGCTGTGC	Tumor
GTGATGTAGCCACTCG	Tumor
ACAAGCTCAGCAGTTT	Tumor
GAGGGTAAGCGCCATC	Normal
ACATTTCGTAGCACAG	Tumor
CCATCACCACTCCGGA	Tumor
ACACTGAAGCAACTTC	Normal
TTGCCTGGTGCTCCGA	Tumor
GACACGCGTGGCTCTG	Normal
GACCCTTGTGTCATGT	Tumor
TCAATTCAGCTTGTGT	Normal
GCCCGAATCACCGGGT	Normal
GGTTAACGTAGTGGCA	Normal
CGTAAGTCAAACACCT	Normal
TGGATGTGTGTCATCA	Tumor
GTCTCACAGACTCCGC	Tumor
GGATCTATCCATTTCA	Tumor
CTGAATGAGTGCTCAT	Normal
AGTGTTGGTTTGGAGG	Tumor
TCGGGTGTCTATGTGG	Tumor
CTCACTGGTTGCGAAG	Tumor
AGAACAATCGTCGATA	Tumor
ACGTCCTCAAATAGCA	Tumor
CGTGATAAGATGCAGC	Tumor
TTTCCTCTCGTTCCTG	Normal
CGGACACCATCGATAC	Tumor
CGATGGCTCCCGAGAC	Normal
GGCTGTGCACGTTCGG	Normal
TGTGCGGCAGTCGAGA	Tumor
AGGTTGTGTTTCACTT	Tumor
ACCCTTGTCAACACCA	Normal
AGGTCATGTTGTAAAG	Tumor
TTAATCCAGTGGCAGT	Tumor
CGTTGGGAGTATAGAC	Normal
CACTGGGGTGAAAGTT	Normal
CTGTGGGAGCCTCGTG	Tumor
TGGTAGTAGCTCACTA	Normal
ATCCATTTCTTTGATC	Tumor
AATGGCTAGACCTCCG	Tumor
GGAGGATGTTTAGTCG	Tumor
CATGCAACATAGACTC	Tumor
TTTAGTCCACTCAAGT	Tumor
ACCTGTCAGGCCATAG	Normal
AAGTCGTTCTACGGGC	Normal
AGATCCATCCTAGCTC	Normal
AAAGAACGTCCCTAAA	Normal
TTTAGTCCAGGTGGAT	Tumor
GCCGATGTCTGAGCAT	Tumor
TGCCGAGTCGCAGTCG	Normal
CTCACTGAGTAACCTC	Tumor
ACAACCATCTACTCAT	Normal
GATCGTAGTTGCGTAT	Tumor
ACGTTCCGTATCGTGT	Tumor
GAGACTTCAGGCATGA	Tumor
GCAGTTACACAGTACT	Normal
CCGTAGGAGTTACGAA	Normal
ATTCGTTGTATCAGCT	Tumor
ATCGTAGTCTTACCAT	Normal
CCGTTCAGTTACGTAC	Tumor
ATACCGAAGTGCACAG	Tumor
AGTGACTAGACCTCCG	Normal
TCAGGTACATTCACCC	Normal
TCCATCGCAAAGTATG	Tumor
GGCGTCACAAATCAGA	Tumor
TCCGTGTCAGAGTGAC	Tumor
CTAACTTAGCGGACAT	Tumor
CCTCACAGTGGGCTCT	Normal
TTTGGAGGTAAGCGGT	Normal
CAGGGCTGTCGTTGGC	Tumor
GACTATGAGCGACATG	Tumor
TAGGAGGTCGGTCTGG	Tumor
CAATTTCGTAAGAACT	Tumor
GTAAGTCGTGCAGTGA	Tumor
ATTACTCTCGGCCTTT	Tumor
CCGGGTAGTGGCTTGC	Tumor
CGAGTGCGTGTTCCAA	Tumor
TCACATTGTGCGGCTT	Tumor
CTCCTTTAGGAAGTGA	Normal
GTCTGTCTCCATTGCC	Tumor
TGCATCCGTCCCACGA	Tumor
ACTATTCTCCCGATCT	Tumor
GATTCGAAGGTAATCA	Tumor
TCCGTGTTCGTCTCAC	Tumor
CATCCGTAGCTGTACT	Tumor
AAGCCATGTTAAGAAC	Tumor
TTTCACAGTCGGCCTA	Normal
TGTAGACTCACGGGAA	Tumor
TGTTTGTCATATAGCC	Tumor
CGAGGAAAGAGGTCGT	Tumor
CCGTTCAAGGTAGGCT	Tumor
ACGATGTGTACGATCT	Tumor
CATCAAGGTTTCGCTC	Tumor
CCTAACCCAGTAACAA	Tumor
AGAAGTAAGTGCCAGA	Normal
GTAGCTATCGTGCTCT	Tumor
TATCTTGGTGTGTCGC	Tumor
CTCCCTCAGTAGATCA	Normal
CTACGGGCAGACACCC	Tumor
GAGTTACGTTGTTGCA	Tumor
AGGAATACAATACCCA	Tumor
GTGCACGGTGAGATAT	Tumor
ACACCAAAGTATAGGT	Normal
GCTTCACAGCTAGAGC	Tumor
GATCACATCGATACGT	Normal
ATCCGTCCACTCCGGA	Normal
GTGATGTAGCTTACGT	Normal
CTGTCGTAGTTACGTC	Normal
GGATGTTTCACTTTGT	Tumor
CGTGAATTCCTACGGG	Tumor
TGAGCATAGGTAGTCG	Normal
TGTCCCACAAACTAGA	Normal
TGAATGCGTAAGTAGT	Tumor
GGGAGATAGCCTCCAG	Normal
CCTATCGCACACCAGC	Tumor
GGCAGTCTCTTCTTCC	Normal
TTGCTGCAGAGTGACC	Normal
TCTTTGAGTCTGTAAC	Tumor
TTCAGGAGTCCAGGTC	Tumor
TCGACCTTCGCCTTTG	Normal
CAAAGAAAGGTACTGG	Normal
AAGGAATAGAGTACCG	Tumor
TTACTGTCACTCTGCT	Tumor
CTGCAGGGTTGGGATG	Tumor
TGCTTCGCATGACTCA	Tumor
GATCCCTCATGTTACG	Tumor
CTCCGATTCTGCCTCA	Normal
TAGAGTCGTCACTTAG	Tumor
GAGATGGCATGACGAG	Normal
AGGGTGAAGACCCGCT	Normal
GCGGAAACAAACACGG	Tumor
TAAGCGTAGCGTTAGG	Tumor
GAGCTGCCACAACATC	Normal
TCTCAGCCATAACCCA	Normal
AACGGGAGTTTCGTTT	Tumor
GCTTTCGAGGTTCCGC	Tumor
AAGACAAAGAGAGCCT	Tumor
CTGTAGAGTGAATATG	Tumor
TCAGGGCAGGGAGATA	Tumor
GATGACTTCTGTCCCA	Tumor
ATCTTCAAGTGGAAAG	Tumor
TTCGATTAGGTAGCCA	Normal
GAAACCTCACCGTCTT	Tumor
CAGGTATTCTGAGGTT	Tumor
AGACTCAAGCGCAATG	Tumor
GTGGCGTCAACAAGTA	Tumor
GTTGAACTCAGTCATG	Tumor
CCTCACACACACCTTC	Normal
CAGGCCACATCCAACA	Normal
TCATCCGCAGCGGATA	Tumor
CTAAGTGAGGAATTAC	Tumor
GGTGAAGCACAGAAGC	Tumor
CAGGTATTCCGGCAAC	Normal
GCCCAGAGTTCGGCCA	Normal
CTTGATTGTGCCCAGT	Normal
TCCTTCTAGGCAGGGA	Tumor
TTTCCTCAGCAGTACG	Tumor
TCACGGGCAGGTACGA	Normal
TTAGGCACACGCACCA	Tumor
CTCCATGTCGTTCTAT	Normal
TTACTGTGTGGTCTCG	Tumor
TGTTCTAGTTCGATTG	Tumor
AGCCAGCGTATCGTAC	Normal
CCGGACACACGGCTAC	Tumor
GCTGAATGTGTCCAAT	Tumor
CTTCGGTAGAAACTGT	Tumor
CTACAGAGTTGCACGC	Tumor
TTTGGTTTCCCGTGAG	Normal
GGATGTTGTAGACAGC	Tumor
GGGTCTGTCGACGAGA	Tumor
GATTCTTTCGTCTCAC	Tumor
GAGACTTAGCATTGTC	Tumor
GTGGTTATCGAACGGA	Normal
ACAAGCTGTACAGAAT	Normal
TTTGGAGAGATGACCG	Tumor
CCAATTTCAGCTGCCA	Normal
TCTATCAAGAAGGTAG	Tumor
TTCAATCTCCGATAGT	Tumor
ATTACCTCAGACGGAT	Tumor
AGCCACGTCTTGGCTC	Tumor
TCACGGGAGACATCCT	Tumor
CCCTTAGAGATGGGCT	Tumor
CCCGGAACATTATGCG	Normal
CATCCGTGTTTATGCG	Normal
CGCCATTAGCTAGAAT	Normal
TCTTAGTGTACGGCAA	Normal
TCTCTGGGTCTTACTT	Tumor
TCGGATAAGTTTGGCT	Tumor
TCAATCTCATAGAGGC	Tumor
AGGATCTAGCTGGAGT	Tumor
CACTGAAGTATGACAA	Normal
AGGTAGGAGCTACAAA	Tumor
TTACGTTTCGGCTGTG	Normal
ATGGTTGGTAACGGTG	Tumor
AATGGCTTCATACGGT	Tumor
TGAGTCATCTAGTTCT	Tumor
TGTTACTCAAGCCCAC	Tumor
AAGGTAATCACCCTGT	Tumor
GATCATGTCCGTGTGG	Tumor
TGCCGAGTCACCCTCA	Normal
AGATAGAGTCCTTGTC	Tumor
AAGAACACAGTCAGTT	Tumor
ATCGGATCAAATGCGG	Tumor
CTGCAGGCACTTGACA	Tumor
TTACGCCAGTTCATCG	Normal
GTGTTCCGTTGAGTCT	Tumor
TTTGACTGTCACCGAC	Normal
ACTGTGAAGACTGGGT	Tumor
TTCTTGACAACTTGGT	Tumor
AGGCCACAGCATGCAG	Tumor
GTGGTTACATCGTGGC	Tumor
GCTGGGTCAACACGTT	Normal
TTCACGCGTTGATCGT	Normal
CCACAAACAAAGAACT	Tumor
TCCATGCTCAGGTGTT	Tumor
TCTTTGATCTCGTGGG	Normal
GGGCGTTAGATACAGT	Tumor
CGAGTGCCATCGCTCT	Tumor
AGGGTCCGTTCCAGGC	Tumor
GGGCCATCAAGCTACT	Tumor
TCACAAGGTCCGATCG	Normal
TTCCAATGTCTAGATC	Normal
GGTGTTAAGGCAGGGA	Tumor
GGCTGTGTCTAGCCAA	Tumor
TGGGATTTCAACCGAT	Tumor
TATGTTCAGTCCGCCA	Normal
GTGTGATTCAAAGGAT	Tumor
CATGCCTGTTGGAGAC	Normal
TGGAACTTCGCCGAGT	Tumor
TTCAGGAGTCCAACGC	Tumor
CACTAAGCATCCTTCG	Tumor
CTTCCTTGTCCAAGAG	Tumor
AGAGAGCTCCCTCAAC	Tumor
GGGAGTATCCATCCGT	Normal
GTGATGTGTCTACGAT	Tumor
TCGCTTGCAAGCACAG	Tumor
GATGAGGCAATCTGCA	Tumor
GGGACCTAGTCGCCCA	Tumor
ACATCGATCGAAGGAC	Tumor
GAGAGGTAGATTGATG	Tumor
GCCAGCAAGTACGAGC	Normal
TCGGGCATCTCTTCAA	Tumor
GGAGAACGTGAGCGAT	Tumor
CGGGACTAGCGAGTAC	Tumor
CAGTGCGAGAGTCAAT	Tumor
ATTCTACCACGTAGTT	Tumor
GGGCCATGTCGGTACC	Normal
ACGCACGAGTTTCGAC	Tumor
ATCATTCAGAGCTGAC	Tumor
AGGCCACCAGCGCTTG	Normal
GAGCTGCAGTCCGTCG	Normal
CGATGCGAGGAGATAG	Normal
TCAAGCACAAGGTACG	Normal
GTGAGTTGTCACCTTC	Tumor
CATGCAAAGTGCAGGT	Normal
CGTGAATTCTACGGTA	Tumor
TTCGGTCTCCTTCTAA	Tumor
CAACGGCAGGTTGCCC	Normal
CGTTCTGTCCCGAACG	Normal
CCCTTAGAGCGGTAGT	Tumor
GTTAGACCACGCTTAA	Tumor
GTCAAACGTAGGATAT	Normal
CACAGATTCCCAACTC	Normal
TGATCTTGTCGGTGAA	Tumor
CCTCACACAGTGTGCC	Normal
CAGCAATTCTCTGAGA	Normal
TACCCGTTCTATGCCC	Tumor
GGGTTATCAGGAAGTC	Tumor
GTCACGGCATCCAATG	Tumor
TCGGATAGTGTAGTGG	Tumor
AGAGCAGTCAAAGGTA	Tumor
TCTCAGCCAATAACCC	Tumor
TCCAGAATCAATCTCT	Tumor
GAATAGAAGGGCCAAT	Tumor
TATTGCTAGCGAAACC	Tumor
AGGTCATTCGGAGTAG	Tumor
ATCACGAAGTTCAACC	Tumor
TTTGATCGTGTTTGCA	Tumor
CTCTCGACATACACCA	Normal
GAGTGAGCACATATCG	Tumor
TGGTACATCCATTTAC	Tumor
ACGTACAAGCGAGAAA	Tumor
AGTAGCTGTTATCTTC	Tumor
ATTCCTACACGCGCTA	Normal
CATTTCATCACACCGG	Tumor
AGGTTACTCACACGAT	Normal
ACTTCGCAGCATCTTG	Normal
TTTACCAGTCACCGCA	Normal
AAGTACCGTGCATCTA	Normal
CTATCCGTCGAAGCAG	Tumor
GTCGTAACAACGGCCT	Normal
CAGCGTGAGCTTTCCC	Normal
GGTTGTAGTCCAGCCA	Tumor
GAATCGTGTCCTCCTA	Normal
CCTCTCCCAGGTTACT	Normal
GCCATTCAGTCATGCT	Tumor
TGATCAGTCTTGAGCA	Tumor
TTTCACAAGCCGTTAT	Tumor
CAACGGCTCGGAGCAA	Tumor
TGGATGTTCGTGGCGT	Tumor
ACCTGAATCGGTGAAG	Tumor
GAAATGAGTACCTAGT	Tumor
TTGCCTGCAATACCTG	Tumor
CTCAGGGTCCAACCGG	Tumor
GAGGCCTAGACCAGAC	Normal
CATGCCTTCACGAACT	Normal
AATGGAATCCTACCGT	Tumor
AGGGTCCGTATCGAGG	Tumor
TTTGACTCATAGTCGT	Tumor
AACCACAAGCTACAAA	Tumor
ATGAGGGCAGACCAGA	Tumor
TTGGGCGCATCACCAA	Tumor
ACATGCAAGGTAAGTT	Tumor
AGGTGTTAGCGAAACC	Tumor
CTGCTCACAGCTCATA	Tumor
TTCACCGCAAACCACT	Normal
CTGGCAGGTACTGTTG	Tumor
AGCGATTCAGGTCAAG	Normal
CAATTTCAGCATCAGG	Tumor
TTGGTTTTCCCTCAAC	Normal
TATCGCCTCGGTGTAT	Tumor
TGATCTTCACAGTACT	Tumor
CACAGGCCACGTACAT	Tumor
AGTAGCTGTACGTAGG	Tumor
CTTGAGACACTGCGAC	Normal
TCGGGCAAGAGCTTTC	Tumor
TACCGAAGTGTCCAAT	Tumor
GATTCGACACGAGAAC	Tumor
GTCCTCAGTCGCACGT	Tumor
TAGATCGAGCTAAGTA	Tumor
CAGGGCTAGGTACAGC	Normal
CCACACTGTCATCCGG	Tumor
GGGTTTAGTATCGCTA	Tumor
ACAAGCTGTATGAAGT	Tumor
TTGCATTCAACCAACT	Tumor
TACGTCCGTACTCGTA	Tumor
GACTATGTCATGCATG	Normal
GGGATGACAGCGTATT	Tumor
CCACGAGTCTGAGGTT	Tumor
TCTCAGCGTTAGCTAC	Tumor
TATGTTCTCATGGTAC	Normal
AGGCATTCACTCAAGT	Tumor
ATTTCTGAGGAGATAG	Normal
GTTGCGGAGATTGGGC	Tumor
TCCTAATGTAGACAAT	Tumor
TGGCGTGGTAGCCCTG	Tumor
TAGCACATCCCGTGAG	Tumor
TTCTGTAGTGTACGCC	Tumor
GACAGCCCATGCGGTC	Tumor
CTCAGGGGTAGAGGAA	Normal
ATATCCTTCAAAGGAT	Normal
TTCTTGATCCGCGGAT	Tumor
CCGAACGCATGCAGGA	Tumor
AGCATCAAGGTGCAGT	Tumor
TGCTTCGGTAGCTGAG	Tumor
TTTCGATTCACGGACC	Tumor
TGCTGAAGTACCAATC	Tumor
CACTAAGGTTCCAGGC	Normal
TCAGTCCTCCCGGTAG	Tumor
CCCTGATCAGAGTTCT	Tumor
ATTCCTAGTGGCTTGC	Tumor
CATCGGGGTTCGGCGT	Tumor
TGTTGAGCACTTGTCC	Normal
GAGCTGCTCAAGCCAT	Normal
GACTGATTCTCGAGTA	Tumor
CAGCCAGCACGGGTAA	Tumor
TCACGCTGTCGATGCC	Tumor
GGGTCTGGTCGATTTG	Normal
AACCTTTTCACCTCTG	Tumor
GAGATGGAGTCCCAGC	Tumor
TGCAGATCATGGCCCA	Normal
TCCCATGCAGAAGCGT	Normal
AGTTAGCCAGAATCGG	Tumor
TACCCACAGTAGACCG	Normal
AAAGGTAAGTTGGACG	Tumor
GATTTCTCAAGCTGCC	Tumor
CTCTCAGGTGGATGAC	Tumor
GATCCCTAGGTGCCTC	Tumor
GGGTGTCTCCGTAATG	Tumor
TCATGAGCATACATCG	Tumor
ATCGGCGTCTGCTAGA	Tumor
GCTTCACTCAGTGTTG	Normal
CAGCGTGTCTCGACCT	Tumor
GTCAAGTCATCGGAAG	Tumor
GTAACACGTGACTAAA	Tumor
CTCATCGAGCCAACCC	Normal
GGGACCTTCTCTAAGG	Tumor
GGCGTCAAGACCCGCT	Tumor
TAGCACACAAGCTCTA	Normal
AACGAAAAGACGACTG	Tumor
GCACATACAGCGTTGC	Tumor
TTGTTTGAGTGCCCGT	Tumor
GTATTGGAGACTACGG	Normal
TAACTTCCAAATGCGG	Tumor
CAGCGTGTCTCCACTG	Tumor
CTCAGGGAGCCGTTGC	Normal
GATAGCTGTTTACCTT	Tumor
GGTAGAGTCTATTGTC	Normal
TTGTTGTTCTGAGAAA	Tumor
ATTCTACCAAGCGAGT	Tumor
ACAGCCGCATCCAACA	Normal
GGAGATGTCGTCCTTG	Normal
GAGGGTAGTCGGATTT	Normal
CACCAAATCGCGGACT	Tumor
TCGGGACCACCATTCC	Tumor
TGACAGTCACTAACGT	Tumor
ACTTAGGCAGGTGACA	Tumor
TCTATACAGTGATAGT	Normal
CCTCAACTCCCGTTGT	Normal
TGGAGAGGTCACCGAC	Tumor
ACAGCCGTCATTCTTG	Tumor
TGTCCACAGATTGAGT	Tumor
ATCGTGAGTTACGCCG	Tumor
GTAGAGGTCACATCAG	Tumor
GAGTTTGGTCTTGGTA	Normal
GAAGCCCGTGACGTCC	Tumor
GCCAGGTAGAAGATCT	Tumor
CCACCATAGAAGTATC	Tumor
TCTACCGGTAACATAG	Normal
GTTGTGATCGCAGTTA	Tumor
TGATTTCGTGAGAGGG	Tumor
CTGCCTATCGGATAAA	Normal
ACCATTTGTGGGACAT	Normal
TCATGAGCAACCGGAA	Normal
GTGTTCCTCAAGAAAC	Tumor
CAATGACCAGTTACCA	Tumor
CTAAGTGAGCGACTAG	Tumor
CTACGGGCACCGTGAC	Normal
TCGCTCAGTCGGATTT	Tumor
CGTCAAATCGGCCCAA	Normal
TCGCTTGAGCTAGATA	Tumor
GAAGAATCAAGGGTCA	Normal
ACGTAACCAGATTTCG	Normal
TGAGTCAAGGAGTATT	Normal
CTCATGCTCGCAGTCG	Normal
CCATAAGGTAGCACAG	Tumor
GATCGTATCACGGGCT	Tumor
TTGATGGGTTGCGGCT	Tumor
ACTTTCATCGCGATCG	Normal
TTGGGATCACATCATG	Normal
CTCATTAAGGCAGCTA	Tumor
TCACATTTCAACACGT	Tumor
ATGGGAGGTCCGGTGT	Tumor
GAGGGTATCCATACTT	Tumor
ATTCTACAGGCGATAC	Tumor
CTACCTGGTCGCTTGG	Tumor
GGACGTCGTCGATGCC	Normal
TCGGGACTCACTGAAC	Tumor
GTTGAACCAGGATTCT	Normal
TACGTCCGTAGACAAT	Tumor
TATCAGGGTTAGGACG	Tumor
CGAAGGACAGCTTTGA	Tumor
CTCAGGGAGTTCCGTA	Tumor
GATAGCTGTTTGTTCT	Normal
CTCAGAAAGATGTTCC	Normal
CGAGTTAGTACATTGC	Tumor
TCTCCGACAGTTCTAG	Tumor
AGGTTGTGTCCCTGAG	Tumor
CAGATCATCTTAGCCC	Tumor
TTTGATCGTCAGACTT	Tumor
ACCACAATCTCTGCCA	Tumor
GCATCGGGTACAGGTG	Tumor
GGCTTGGAGACGATAT	Normal
GAAGCGAAGGACGCTA	Tumor
CATCAAGAGTGTTCAC	Tumor
GACACGCAGAAGGCTC	Normal
CAGTTCCCAAAGCGTG	Tumor
TCAAGTGGTCCTCCTA	Tumor
GTCCACTGTCTAATCG	Tumor
TTCCTCTCATGATAGA	Tumor
TGGGTTAGTAGGAAAG	Tumor
CCCGGAATCCCGAGGT	Normal
GTAGTACTCGACCAAT	Tumor
ATTGGGTAGTGTTGAA	Normal
TTGCTGCTCGACATAC	Tumor
GTAAGTCTCTACCTTA	Tumor
AGGGTGACACGACAGA	Tumor
AGACTCACATAGGTTC	Tumor
GAGTGAGGTATGCGGA	Normal
TGTTACTTCGATACGT	Tumor
AACCATGAGATGCAGC	Normal
GGTGATTCAAACGAGC	Tumor
GACTCTCCATGCACTA	Normal
CCTATCGGTAACAGTA	Tumor
ACTGTGATCTGTGCGG	Tumor
TACACCCTCCAGTACA	Tumor
TCATTCATCTATACTC	Tumor
TCAATTCGTAGAGCTG	Tumor
GGAATGGAGAATCCCT	Normal
TCTACCGGTACCGGAA	Tumor
GGGAGTAGTCTCTCTG	Normal
GTTACGATCGCAGATT	Tumor
GTCTACCAGTGCAAAT	Tumor
ATGAGTCGTTGTAAAG	Tumor
CCTCCTCGTAACTGCT	Normal
CTCAGTCGTACGCTAT	Normal
CCTCCAAGTCCAAAGG	Tumor
CGAGTTACAGACCATT	Tumor
ATTCGTTCATCGTTCC	Tumor
CCTGCATAGCCATCCG	Normal
TTTGGTTTCTCTGACC	Tumor
ACGTACACAGTAGAGC	Tumor
TACTTCATCGCGTTTC	Tumor
TGGTAGTAGTTACGAA	Tumor
ACGTTCCCATATCTCT	Normal
GAGCCTGTCTAGTTCT	Tumor
GACCTTCAGACCATGG	Tumor
GAGCCTGCATCCGCGA	Tumor
ACTTTGTCAGCGAGTA	Tumor
ACGTAGTGTCCAGGTC	Tumor
TACGGTATCGGTGTAT	Tumor
CACGTTCGTACCAATC	Tumor
ATCACGACAGGCTCTG	Tumor
TATACCTAGGTTGTTC	Tumor
TCGCTCAAGCATAGGC	Normal
ACATCCCAGAGCATTA	Tumor
CTGAATGAGTCACTCA	Normal
GGCGTCAAGGTAGTCG	Tumor
GAAGGGTGTCAGGCAA	Normal
CCTGTTGTCCTGTAAG	Normal
TTACCGCTCTGCAGCG	Tumor
TTACAGGAGCCTGAAG	Tumor
AATTTCCGTAGCGATG	Normal
CAGATACGTGTCATGT	Tumor
CACGTGGCATACAGCT	Tumor
ATCGATGGTGGACCAA	Normal
AATTTCCCATAGGTTC	Tumor
ACGTTCCCACACGGAA	Normal
GTCAAACTCTGTTGGA	Tumor
ACTTCGCAGCATAGGC	Normal
AGTTCCCAGGCCTTGC	Tumor
GAGTGAGGTACCCAGC	Tumor
GGGACAAGTCCAGAAG	Tumor
AAGGTAAAGGGCCCTT	Normal
GTTTACTGTGCGTTTA	Tumor
ATACTTCGTGGCAACA	Normal
GTCTCACTCTAACACG	Tumor
GGGCTACTCATACGAC	Normal
TGGGAGAGTGCCTTCT	Tumor
AGTCATGAGGGTCTTT	Tumor
TTGCATTTCGGTCATA	Normal
CATACTTCAAGATGGC	Normal
CTGTATTCATCCTTCG	Tumor
TGTCCCAGTGAATAAC	Normal
AAACCCATCTAAGCGT	Tumor
CTCCATGCATTCTCCG	Normal
ATCCATTCACCCGTAG	Tumor
GTGCAGCTCGTAGTGT	Normal
AAGTGAACAGACCTGC	Tumor
TCGTCCAGTAGCGTAG	Normal
AATGGCTTCCCGTTCA	Normal
CCACACTAGCCGATAG	Normal
TCTTTGACACGGTAGA	Tumor
TTGGATGAGTATGTAG	Tumor
CGTAATGAGAGCCTGA	Tumor
AAAGGATAGAGGGTGG	Tumor
CGGGCATAGTAAGCAT	Tumor
TCCTGCAAGTTGGGAC	Tumor
CACAACATCTCAGGCG	Tumor
TGCTGAATCGCTGTCT	Normal
CTCTCGAGTGTTAACC	Normal
ACCATTTCATAAGCAA	Normal
GTCAAACAGTATAGGT	Normal
CTCTGGTAGGCTAAAT	Normal
TATCGCCAGAGGGCGA	Tumor
AGTACTGCATGGATCT	Tumor
GCCGTGAGTTCTCAGA	Normal
TGTGAGTGTAATGATG	Normal
AGCGCCAGTCACAGAG	Normal
AGCCAGCGTTTCCATT	Tumor
TCGTCCATCAACACCA	Tumor
CGAGAAGCAGGTACGA	Normal
GCCGTGACAACTCGAT	Normal
AGTCAACGTTTCCCAC	Tumor
TGTCAGATCACATTGG	Tumor
CTGAATGCAACTGCCG	Tumor
GGTGTTACAATAGAGT	Normal
GTGTAACGTTGGATCT	Normal
TGCAGTAAGTCACGCC	Normal
TTGGGATTCGACCATA	Normal
CTCTCAGTCTCTTGCG	Tumor
ATGATCGGTCCTTTGC	Tumor
ATTCCCGAGATAACGT	Tumor
TCCGGGACAAACTCGT	Tumor
TGTGGCGGTGCTGCAC	Tumor
TTCCGGTGTTCCACGG	Normal
GGCTTGGTCGAGAATA	Normal
TGTTCATCAAATACGA	Tumor
CATCCACTCACCTGGG	Normal
TGTCCTGGTGGAGAAA	Tumor
TCCACCACAGCTACCG	Normal
AGGGTTTGTTTCGACA	Tumor
GGGCTACTCGTTCCCA	Normal
ATCCCTGGTTCTATCT	Tumor
CGCATAAGTGTACGCC	Tumor
ATCTCTAGTAAGATCA	Normal
TTTACTGCAAATCCCA	Tumor
CAACGATTCTACCTTA	Normal
AATAGAGTCTAGCCAA	Tumor
ACGTAGTGTAGACTGG	Tumor
AACGGGAAGCCGGAAT	Normal
TAGGAGGAGGAGAGGC	Tumor
TGAGCGCCAAGAGCTG	Tumor
CCGGGTAGTCATCCCT	Tumor
TACACCCGTTGCCAAT	Tumor
TCAGGGCGTCCGGACT	Normal
AGATCGTTCGCAAGAG	Tumor
TTCCGGTAGTGCTACT	Normal
ACCTGAAAGGCTTAGG	Tumor
TGTACAGAGATTGAGT	Tumor
CTGGCAGTCTAGGCCG	Tumor
TTAGGGTCAGTCTACA	Normal
AATAGAGGTGGGTCAA	Normal
TCTATCAAGGTCCCGT	Tumor
CGATGCGTCCGTGGTG	Normal
AGCGTATCATAATCGC	Tumor
AAAGTGAAGTAAGGGA	Normal
CAGAGCCGTAACACCT	Normal
GCACGTGGTTGCCATA	Tumor
GTCTTTAGTGAGTAAT	Tumor
TCATACTCAATGGGTG	Normal
GGCTTTCGTGAGATCG	Normal
ACTGTGACAGAACATA	Tumor
CTCTCAGGTAGGGTAC	Tumor
GTGCACGTCAATCTCT	Normal
GGGAAGTGTGAGAACC	Tumor
GCAGCTGCAGCTATAC	Tumor
AGGCATTAGCCATATC	Normal
TTGTGGAAGCATTTGC	Normal
ATGGAGGAGTGCTAGG	Tumor
CTGGCAGAGATTAGTG	Tumor
TCTATCATCGAAGGAC	Tumor
GTACAACTCAGCCTTC	Tumor
TCTCCGACACAACGTT	Normal
AGTTAGCAGGTCGCCT	Normal
GGTCTGGTCTCAGAAC	Tumor
GTCATCCGTATCACCA	Tumor
CTACGGGGTATACCTG	Tumor
TATACCTTCAAGTGTC	Tumor
TGCTGAAAGTATCCTG	Tumor
TTAGGCATCGCTTTAT	Normal
AAAGGATCACTCCGGA	Normal
TCTGCCATCGTGCACG	Normal
CATACAGCAGAACCGA	Normal
CCTTTGGCAAGCGAGT	Normal
TAATCTCGTACCGGCT	Tumor
ACCTGTCCATTCCTCG	Normal
GAACACTGTAGACAAT	Tumor
GTATTGGCACCTCTAC	Tumor
TCATCCGGTCTAGGTT	Tumor
CTACAGACAACCCTAA	Normal
GGTTCTCAGACTACCT	Tumor
GCGATCGAGCGCAATG	Tumor
CGGACACGTTGCGTAT	Tumor
TCAAGTGCAACGCATT	Normal
GGTTCTCAGTGGATTA	Normal
CGAAGTTGTCCTTAAG	Tumor
TGACTCCTCGCCGAAC	Tumor
GGAAGTGCAATTGCAC	Normal
AGAAATGCAACAGTGG	Tumor
ACTGTGAGTTGTCATG	Tumor
CGTGATAGTCCACATA	Tumor
ATCACAGAGTACGTCT	Tumor
ACTATTCGTAGCGTCC	Tumor
TGGTGATAGAAGGGAT	Tumor
TTCGATTGTCTTCATT	Tumor
GGGAGTAAGCAGGTCA	Tumor
AGCATCAGTAGGACTG	Normal
CACGAATAGGGTGAAA	Tumor
GTCCCATCACACCGCA	Tumor
GGAGCAATCGATGCTA	Tumor
TCTGTCGAGCAATAGT	Normal
TTACGTTCAAAGGCGT	Tumor
CACAGATTCAGTCACA	Tumor
CGTTAGAAGATACCAA	Tumor
ACACAGTTCATGCATG	Tumor
CACAGGCGTTTCCCAC	Normal
CGTGCTTGTTGAGGAC	Tumor
TTTCAGTCAATCCTTT	Tumor
GGGCTACGTCTACAAC	Tumor
GACCCTTTCTACACAG	Normal
GCCAGGTTCTGTGCGG	Normal
AGTCTCCAGTAGTCAA	Normal
CATCCGTCATAACCCA	Tumor
TACACCCAGGCTGTAG	Normal
GTCCCATGTTCAACGT	Tumor
TACCCGTAGCTTAAGA	Tumor
TGGGAAGGTGCACATT	Normal
TGAGGTTAGTCACACT	Tumor
ACAGGGATCACTAGCA	Normal
ACGTTCCTCTATTCGT	Tumor
AGACACTCATAGGCGA	Tumor
TGTAACGCAGCGGTTC	Tumor
CTCAGAAGTGCATTTG	Normal
CATTGTTAGCGATGCA	Normal
GTCTGTCGTGTTAAAG	Tumor
TATCCTACAGCACCCA	Tumor
CCTCCAAAGCGTCTGC	Tumor
TAGAGTCAGAGCGACT	Normal
CGGGTCATCTGCGTCT	Tumor
GAAGCGACAATTAGGA	Normal
CCCGGAAGTATTGGCT	Tumor
TGCTCCAAGTGGAAGA	Normal
TACTTCATCAGTGTCA	Normal
CCTCCTCGTTGTGCCG	Tumor
TTGTTTGTCGCGTGAC	Normal
ATACCTTAGTGTACCT	Tumor
CTCAGTCCACGAGAAC	Tumor
ATTACCTCACACCTTC	Normal
TCGAAGTTCGCATTAG	Tumor
TGCGGCACAGGTTCAT	Normal
GTGATGTCATTGCTGA	Tumor
TCATGAGCACCAGTTA	Normal
CCAATTTCACCAGCGT	Normal
AGGAATATCCCGAATA	Tumor
GCTGAATTCTGTACAG	Tumor
TTTACTGGTCCTCATC	Tumor
AGGAGGTTCGGAGATG	Tumor
TGTGTGATCCGGTAGC	Normal
TGGTAGTCACCGTGAC	Normal
GAGACTTGTCGCATCG	Normal
GTGAGGAAGATAACGT	Tumor
AGATCGTGTTCGGCGT	Tumor
ATTCCATCAGCTTTGA	Normal
AGGCTGCTCGGTTAGT	Normal
GAGTCATGTAACACGG	Normal
AGCGCTGTCCGATGTA	Normal
TCAGTCCCAAATCGTC	Normal
CAGATTGCACGTCGGT	Tumor
TCACAAGAGAGAACCC	Tumor
ATGGGTTTCCGAGATT	Normal
TTGGGATTCGAGCTGC	Tumor
TCAAGCAAGATAACAC	Normal
GCTTTCGGTATAATGG	Tumor
TGCGGGTGTGTGATGG	Tumor
CTGTGAAAGGGACAGG	Tumor
TACCCGTGTTCGATTG	Tumor
ACGCACGCACTTGAAC	Tumor
TTCCGGTAGATGACCG	Normal
GCAGCCAAGCGAGTCA	Tumor
ATTCTACGTATGTGTC	Tumor
TGTACAGTCTGGACTA	Normal
GACATCACAACCACAT	Tumor
CTATCCGCACGCGTCA	Tumor
GCTTTCGAGACTAGAT	Normal
GTTCATTCACAGTGTT	Tumor
GGTGTTAGTATAGCTC	Tumor
ACTTTGTAGTCGTTAC	Normal
GTCAAGTCAAGCCCAC	Tumor
AGAAGTACATGGAATA	Tumor
TCAAGCAGTCTTGCGG	Normal
TTGTGGACATGTACGT	Normal
TTATTGCCACATTACG	Normal
TCGGGTGGTGATGAAT	Tumor
CCCTCTCAGGCTAACG	Tumor
TCTACCGCAACGAGGT	Normal
CAACAACCACAAGCTT	Normal
TGGTAGTAGAGTACCG	Tumor
CCGATGGCATAATGAG	Tumor
CCAATTTCATCCCGTT	Tumor
TCTTAGTAGAATCTAG	Tumor
AGTGACTAGTCAAGCG	Tumor
TCGTCCACATTCCTAT	Tumor
CAACGGCGTAGGACCA	Normal
CCTGTTGCAGGCGAAT	Tumor
ACGATCAAGGTAAGTT	Normal
CTTGAGACAGAATTCC	Normal
TTCTAGTGTCGGTGTC	Tumor
CCGGTGATCTCCTGAC	Normal
AGGCTGCTCGGTTCAA	Normal
TACATTCGTCGATTTG	Tumor
GGTCTGGAGCGTATAA	Normal
CAACAGTAGAGAGCCT	Normal
TAGTGCAGTGACAACG	Normal
CATCCCATCTCCGTGT	Normal
CTGGCAGAGTTCAACC	Normal
CTCGAGGAGCGCACAA	Tumor
AGTGTTGCACTACCGG	Tumor
AGTTCCCAGCATCAGG	Tumor
AGAAATGCAGCTATAC	Tumor
TGGGTTACATGACCCG	Tumor
TCCGATCGTCTCACAA	Tumor
GATGAGGCATCCGAGC	Normal
TGGATGTAGGAAAGGT	Tumor
TCACGCTCATCGTGCG	Tumor
ACATTTCGTGATAGTA	Normal
TTGAGTGAGATGGGCT	Tumor
CGTCCATTCGTTGTGA	Normal
AGGACGAAGCCTGAGA	Tumor
CTCCACAAGAATAGTC	Tumor
TGGAGAGAGCCGCTTG	Normal
ACGTACAAGAGCAGCT	Normal
CGAGAAGCAAGGACAC	Tumor
TACCGAACAAATTGCC	Normal
CCTCAGTGTACAAACA	Tumor
GGAAGTGGTCATTGCA	Tumor
GGAGGATAGTCTAGCT	Tumor
TTGAACGCACCAGCCA	Normal
AGTTCGATCGGATTAC	Tumor
ATTGTTCTCAGCACCG	Tumor
CTGTGAAGTAGTCGTT	Tumor
ATGCCTCTCTGGGCAC	Tumor
CAGATTGGTTTCGCTC	Tumor
ACAACCACAGCTGGTC	Tumor
TAGATCGCATAGGCGA	Tumor
GTAGCTAGTAACACCT	Normal
CTCAGGGTCAGGAGAC	Normal
TTCTAACAGACGGATC	Normal
AACAAAGCATGCAGGA	Normal
GGGTCACCAAGGCCTC	Tumor
AGGCATTGTATGAGCG	Tumor
TGAGCGCGTGTTAGCT	Tumor
CATCGGGCACTACCGG	Normal
GGTGTTAAGCATGCGA	Normal
TGCTTGCCATATACCG	Normal
TAGTGCAAGAGAAGGT	Tumor
ACCGTTCTCTCTATAC	Normal
CTTTCGGCACACGGTC	Normal
CTGGACGGTCGCTTGG	Normal
TTGCTGCCATCCGAGC	Tumor
TCTACATCAATAGGGC	Normal
TAGAGTCGTATTCTCT	Tumor
AGGTGTTGTCGGAAAC	Tumor
TCTTTGAGTAGTATAG	Normal
GTTATGGTCCATATGG	Normal
AACACACCAAAGCTAA	Normal
TATCTTGCAAGACTGG	Tumor
TGGAGGAAGTTGGCGA	Tumor
GTGGTTACATGCACTA	Tumor
CTGGACGGTCGACTGC	Normal
CAATACGGTTGGGAAC	Normal
TGGAGGAGTCGTTATG	Tumor
GTTACCCAGACCAAAT	Tumor
GTGCTGGGTGCGCTCA	Tumor
TGAACGTGTGCAACAG	Tumor
CCACGTTCATTCATCT	Normal
GTTTGGAGTCAGGTAG	Tumor
GCAACCGAGTTCACTG	Normal
TATATCCAGCTAGTTC	Normal
AACAAAGCACCTTCCA	Normal
TAGGTACGTTGTCCCT	Tumor
GCTACAAGTTATCTTC	Tumor
GTCCACTTCCGTATGA	Tumor
AGGAATAAGAATACAC	Tumor
TCTTTGATCCATGAGT	Tumor
GAAGTAAAGTTCTACG	Tumor
ACGGTCGGTCCTTTGC	Tumor
TACTTCAGTTCTAACG	Tumor
GTGCGTGAGTAATACG	Tumor
GATTCTTTCTCCGTGT	Tumor
TCCATCGGTCCTCCTA	Normal
TTAGTCTAGCAAATGT	Normal
CTCCTCCCATGGCACC	Tumor
GTCTACCGTCGAGTTT	Tumor
GGGTCTGCAATAGTGA	Tumor
CTGCGAGGTAGCGTCC	Tumor
GTAGAGGCACCTCTGT	Normal
ACATCCCGTAGTCGGA	Tumor
AACACACAGCTGCGAA	Normal
GGAGGTACATAGATGA	Normal
TTGCCTGAGGCAGGTT	Tumor
AGTTCCCGTTGTGGCC	Tumor
TCATCCGCAGGAGGAG	Normal
TGGGATTTCACTGGGC	Normal
GGCAGTCAGTGGTTGG	Normal
GGGTGAATCACCTCAC	Normal
ACAAAGATCTACGGGC	Normal
TCATGGAAGATAGTCA	Tumor
AATTCCTCAAAGGCGT	Tumor
CCGTGAGGTCTGATCA	Normal
GGGATGATCGTAACCA	Tumor
TGACAGTTCCAAGCAT	Tumor
GTTCATTGTCTAATCG	Tumor
CCGGACACACTGGACC	Normal
TGAGTCAAGGCATCGA	Tumor
GTCGTAAGTTCCACAA	Tumor
ACATCCCAGTCGCTAT	Tumor
TCCTTTCTCTCGTCAC	Normal
CTCCTTTAGTATGAAC	Tumor
GTGCGTGCATGGACAG	Normal
GCTTGGGGTGGAACCA	Normal
TCTTAGTAGAACAGGA	Tumor
TGTTTGTGTGCGAACA	Tumor
GTAGAAAAGTAACAGT	Normal
GTGCAGCAGTCGAGGT	Normal
ATGACCAGTACCGGCT	Normal
GTAATGCGTCCGAAAG	Normal
TGCATCCCAATAACGA	Normal
GGAATGGAGTTCATGC	Normal
CAAGACTTCCCGTGTT	Normal
TGTTGAGGTCATGCAT	Normal
GTAACCAAGATGGTCG	Tumor
CTGCTCACACAACCGC	Tumor
ACCGTTCAGCTTTGTG	Tumor
ATCCGTCGTGGTATGG	Tumor
TCCGTGTGTCTTTCAT	Normal
CAGATTGCAGCTCATA	Normal
GGAGAACCAGTCGCAC	Normal
GATAGCTAGACTCAAA	Tumor
CAGGCCATCTATTGTC	Tumor
AATCGTGGTTGAGTCT	Tumor
TTCGATTCACCAGCGT	Normal
GCTTGGGGTCCCTGTT	Tumor
TCATTTGTCGTTACCC	Normal
CACTAAGGTCGGAACA	Normal
TCTCACGGTTGGGTAG	Tumor
TTCACCGAGTAGGAAG	Tumor
TTCATGTAGAGCTTTC	Normal
TGTTCCGAGACTTAAG	Tumor
ACTTTGTGTTCCGCTT	Tumor
GAATCGTTCATTCTTG	Normal
GTAGAGGCAATAGTAG	Tumor
CGGAACCAGGGCAGTT	Normal
TGACAGTCATCGGAGA	Normal
GACCCAGAGTAGCATA	Tumor
TGAATGCTCATGGGAG	Normal
ATCGTCCAGAGATCGC	Tumor
CACTGGGGTCTTACTT	Normal
GGCTGTGCAAATGATG	Tumor
CTGCCATGTCGATTAC	Tumor
TTAATCCGTCGAATTC	Normal
ATGTCTTTCTCGGTAA	Normal
CGCCAGAGTTCGGCGT	Tumor
CATTGTTTCTTCGGAA	Normal
TTTCGATCATATCTCT	Tumor
TATCTTGCAAGACAAT	Tumor
GTTGTCCGTCCTCATC	Tumor
ATCACAGAGCCGATTT	Tumor
TCTAACTGTTCGTAAC	Normal
CATCGTCTCGGTCACG	Tumor
GTGGAAGCAAGGACAC	Tumor
GAATAGACACTTGTCC	Normal
CTCCACACAAAGGATT	Tumor
ATTCAGGAGGATCATA	Tumor
GAGGCCTGTACTGGGA	Normal
GTCACTCGTTCCCAAA	Normal
TGGGAAGTCACTTTGT	Normal
ACCGTTCCAAATGAGT	Tumor
CGTTCTGCAATCGAAA	Tumor
CAGTTAGTCATTACCT	Normal
GCCGTGACATGCCATA	Tumor
GATCGTATCGCCAGTG	Normal
CGTTAGAAGGGCTGAT	Normal
TTGGGATTCACTCTTA	Tumor
TTACGTTCAGCGATTT	Normal
CCGGGTAGTGACGTCC	Tumor
GGTGTCGGTGAACCGA	Normal
TCAGCAACAAGTATAG	Tumor
TGTACAGTCGTTCTAT	Tumor
TCGGGCAAGCGAGTAC	Tumor
ATTGGGTCATGTCTAG	Normal
ACTTCCGAGGATACCG	Normal
TCGGTCTCAGGAGGAG	Normal
CCAAGCGAGACTCATC	Normal
TTTCGATTCTCTGGTC	Tumor
GTGCAGCAGACCCTTA	Normal
AACAGGGTCGAGCCTG	Tumor
AACCCAACAGCGATTT	Normal
CTATCCGGTTGCAACT	Normal
CATACTTTCATTCCTA	Tumor
CATCCACCACAGTATC	Normal
TGCTCCAGTAAGATAC	Tumor
GCGTTTCAGGTAGCAC	Tumor
GCACATACACACGTGC	Tumor
ACTTTCAAGGTACCTT	Normal
GACTGATAGTTGGACG	Normal
TGGCGTGGTTCGTGCG	Normal
ACTTTCAAGCCTTCTC	Normal
GGACGTCGTGGATGAC	Tumor
TGATGCATCCTTGACC	Tumor
GGTGTTACAGCTCATA	Normal
CGTTAGACACTACCCT	Normal
CAGCCAGGTAGGTTTC	Tumor
GAGTTACAGTCTACCA	Tumor
GTTGTGATCGTGGACC	Tumor
ATCATTCCACACCTGG	Tumor
ACACTGAAGTAGGAAG	Tumor
CCTCACACAATAGAGT	Tumor
GCGATCGCAACAGCCC	Tumor
TGGAGGACAGCTTCGG	Tumor
TATCGCCTCGCTAAAC	Tumor
TTCCTCTCAGTCCGTG	Tumor
GAAGCGACATGCAGGA	Normal
GGAACCCGTCTTCGAA	Tumor
ACTTCCGGTACGTGTT	Normal
GCAGCCAGTTCTTGTT	Tumor
TAAGCGTGTGCACAAG	Tumor
ATGGGAGTCGGTCAGC	Tumor
CTGGACGCACGATTCA	Normal
CTGCCTAGTAGAAACT	Tumor
TGCTCCATCGTGTCAA	Normal
AGGTAGGAGGATGTTA	Tumor
AGGTTGTCAAGGTCGA	Tumor
AGGAATACACAACGAG	Tumor
CCTAACCCAATTGCTG	Normal
GCGGATCAGCTCGTGC	Normal
TGATGGTAGATTGGGC	Tumor
AACACACTCCTGTAGA	Tumor
GACTATGCAGGTGTTT	Normal
GGGTCACGTAATTAGG	Normal
GTCGTAACACGTTCGG	Tumor
CTTGATTAGTTTGCTG	Tumor
TCTTGCGCACTGCTTC	Normal
TTCTAGTGTGTGTCGC	Tumor
AGAAGTAGTCATATGC	Tumor
GCTGAATAGACTTAAG	Normal
TCTGCCAGTCCCTGTT	Tumor
GATGGAGTCTGAACGT	Tumor
TGCGGGTGTGTCCTAA	Tumor
TCTTCCTTCCTCTTTC	Normal
ATTGGGTAGTATTCCG	Tumor
GGCTTTCAGACATGCG	Tumor
GTAGGTTAGTTGCTGT	Tumor
AAGTACCTCGGAATGG	Tumor
TCGCTTGTCGTAACCA	Tumor
AAAGGATTCTTGCGCT	Tumor
CCGGTAGAGATTCGAA	Tumor
GCGTGCAAGATAGCTA	Normal
ATCTTCATCGCTATTT	Normal
GTTCGCTCACGTACTA	Normal
GCTGGGTTCGATACGT	Tumor
TGACGCGGTGGTAACG	Normal
TCACAAGTCCGCTGTT	Normal
ATTCGTTGTGCGTTTA	Tumor
GTTACGAGTATCGCGC	Tumor
AGCTACACAAGACGAC	Tumor
CATCCACCACGACCTG	Normal
CGGGTCAAGTTTCAGC	Tumor
GCTGGGTGTTCGGACC	Tumor
CATTGTTCAAGGATGC	Normal
TCATATCTCTGAGAGG	Normal
CGTTAGAAGTGATTCC	Normal
AGCTCAAGTATAATGG	Tumor
CTCTGGTGTACCATAC	Tumor
GATAGCTAGGGTGGGA	Normal
GACTGATCAGTCTTCC	Tumor
CCTCTAGCAGAGCGTA	Normal
ACAAGCTTCTGGGAGA	Normal
TGAGGTTTCTGTCGCT	Tumor
ATTCCCGTCATCGCCT	Normal
ACGTTCCTCGCATAGT	Tumor
TGCGGCACACTATGTG	Normal
CAGTTCCAGAAGCCAC	Normal
AGCGTATGTTCACCGG	Normal
ACAAGCTAGCTTTCTT	Tumor
GTCTTTAAGAGCCGTA	Tumor
GGTCTGGGTCACTTCC	Normal
GACGCTGCATACCACA	Tumor
TACAGGTCAATTGCGT	Tumor
GTAGCTAGTATCGAGG	Normal
TGACTCCAGCGTTCAT	Tumor
TTACGTTTCGGCATCG	Normal
TCTCAGCCAATTCTTC	Normal
TTCACGCAGCTAAGTA	Normal
TCAAGTGGTATCGCAT	Tumor
GTAGAGGGTGATCGTT	Normal
CTGGACGTCTTTGCTA	Normal
TTCATGTCAGCAGACA	Normal
TTGCCTGAGCACCGTC	Normal
AGCCAGCGTGAGATAT	Normal
TTACGCCTCTTTCGAT	Tumor
TCTGGCTTCTCGACGG	Tumor
CGGAGAATCAGCTTCC	Normal
CTCATCGAGTTGGGAC	Normal
AAAGGGCTCTGCGAGC	Normal
GTGGTTAAGTAACAGT	Normal
AGGGTTTAGGCATGCA	Tumor
CCCGAAGGTAATGCTC	Normal
ATCATTCTCTGGTTGA	Tumor
TCGGTCTCACTACTTT	Normal
CAACAGTTCAGTAGGG	Normal
AAAGTGAAGTAACGAT	Normal
TCAAGTGAGGGAGGCA	Normal
GTAACCAAGGGAGGTG	Tumor
TCTACATCACTCATAG	Tumor
ATAGGCTGTATCGCGC	Normal
ATACCGATCACAATGC	Normal
GCGAGAATCTGTCCCA	Tumor
AGTTCGAAGCTGCCAC	Tumor
ACTTCGCCAGGCGTTC	Normal
AAAGTGACAAATACAG	Tumor
TTCATTGAGTGTTGAA	Tumor
AGTGCCGCAGTTGAAA	Normal
TTTGGTTCAGTCAGAG	Tumor
ATTCCCGCAGGTTCGC	Normal
ACTCTCGAGGCATTTC	Normal
CTTCTAAAGTCGAAAT	Normal
GTTGAACGTTCGCGTG	Normal
ACCAAACCATGCAGCC	Tumor
CGAAGGATCAAGCCAT	Normal
TCGATTTTCGCGTGCA	Normal
AGTGATCAGCATGATA	Tumor
TGGGAAGAGGCAGGGA	Normal
GGGCGTTAGTTCGGTT	Normal
CCGTTCAGTGCAACGA	Tumor
CTCTCGACAGGCAATG	Tumor
GACCGTGGTGCAGTGA	Normal
TTCTAGTCACTCATAG	Tumor
CTCAGAAGTTGGACCC	Tumor
ATTACTCGTAGCGAGT	Tumor
CCTCACACAAGGGTCA	Normal
GTTCGCTGTTGTGTAC	Normal
CCTAACCAGGAGTCTG	Tumor
GCCAGCATCTCCATAT	Normal
CGTGAATGTACATTGC	Normal
ATGAGTCGTGTACGCC	Tumor
GGTCTGGGTCAGGTGA	Normal
CTACAGATCCTGGGAC	Tumor
CTGCAGGGTATGAGAT	Normal
CTGCAGGGTAAGTTAG	Tumor
GTCGTAACAGAGCTAG	Normal
TAGAGTCGTATATGGA	Normal
CATCGCTTCAGCCTTC	Normal
AGACACTAGACGATAT	Normal
AGTAGCTGTGTCTAAC	Tumor
AATTCCTCAACGACAG	Normal
GACAGCCTCCCGAGGT	Normal
GTCATTTAGAGTAACT	Tumor
ACATCCCGTTGGGTTT	Tumor
TGTGCGGTCGCACGGT	Normal
CAGATACGTTCTCGCT	Normal
ACTTTCACACAACGAG	Normal
CGTCCATTCGGTCATA	Tumor
GGTTCTCAGGAACTAT	Tumor
GTGTGATCATTGCTTT	Normal
CGTGATAGTATGAGAT	Tumor
CCGATCTAGCGCCGTT	Tumor
GAGAGGTAGAGGCTGT	Normal
ACAAAGACACATTGTG	Normal
TCAAGACAGTTAGAAC	Normal
CAGCACGGTACACGTT	Tumor
CTTTCAACATCGCTCT	Normal
ACTTTCATCTGTCGTC	Normal
TCGTGCTGTCAGTCCG	Normal
TTTCCTCCAGTCTGGC	Normal
TCTCACGGTCGTGTTA	Tumor
TTTATGCTCCAACCGG	Tumor
CCAATGATCGAGCTGC	Tumor
AACGTCACACCCAAGC	Tumor
ATGAGGGTCTGAGGCC	Tumor
CTGAGCGCACGTGTGC	Tumor
TTCATGTAGTAGATCA	Tumor
GGGTCTGGTAGTAAGT	Normal
GCCATGGTCACCGCTT	Tumor
CTTTCAACAGGTTCAT	Tumor
TCTGGCTTCTTGTGCC	Normal
GTAACACCAAAGAGTT	Tumor
TCACGCTAGGCTGTAG	Tumor
GATGTTGAGCTTGTGT	Normal
ACCAACATCGTGGGTC	Tumor
ACATGCATCGAAGCAG	Normal
ATTACTCTCACATCAG	Tumor
GCATCTCGTGGTAATA	Normal
GATGAGGTCGGCACTG	Normal
CTCTGGTCAGAAATCA	Normal
ACTCTCGTCAAGGAGC	Tumor
CCTCATGGTCCAGGTC	Normal
CGCGTGATCAACTGAC	Normal
GCATCGGCAGACCAGA	Tumor
TTACTGTCAGGATTCT	Normal
TCACGGGTCGGCTGAC	Tumor
GAGTGTTAGCGCCGTT	Normal
GGATGTTTCATTCACT	Tumor
GGGCCATCATTACTCT	Normal
TCAGTTTAGCGCGTTC	Normal
GTCGTAACATACATCG	Tumor
TTTCATGAGCGAGAAA	Normal
GTCATGAGTCAGGCAA	Normal
TGCTTGCTCCATTTGT	Normal
CATGGTACATAGCACT	Tumor
TGCGGGTGTTAAGGAT	Tumor
CCACAAAAGCCATTGT	Tumor
CGATCGGGTCCCACGA	Normal
GAGTCATCAATCCAGT	Normal
GGGCTCAAGTATGGCG	Normal
ACTCCCAAGCGACTGA	Tumor
TCATATCCACAATTCG	Tumor
ATTCACTCATGACAGG	Tumor
GGGTGTCCACGATAGG	Tumor
GGCACGTGTACGGCAA	Tumor
TCACAAGGTCGTATTG	Normal
GATTCTTGTCGCTTGG	Normal
TCAGTCCGTTAGGCCC	Normal
GCACATACATCGTTCC	Normal
CGTGTCTGTACTTGTG	Normal
TGTGAGTAGTTTGGCT	Tumor
GAGTTACAGCCTTTCC	Normal
CAGGGCTAGCGTCTCG	Tumor
TCTCCGAGTATCGTTG	Tumor
CGTCAAATCAAAGCCT	Normal
CACAGATTCGTTACCC	Tumor
ATCGTGAGTCAATGGG	Tumor
AAACGCTAGAGTCTTC	Tumor
CGCATAAAGCACTCGC	Normal
GTCACTCAGATGATTG	Tumor
AATGACCAGGTTATAG	Normal
GAACACTTCTCTAAGG	Tumor
TTTAGTCGTGGTAACG	Normal
CTACAGACACAGTGTT	Tumor
GGATCTAAGATTAGAC	Normal
TTGTGGAAGCTACGTT	Tumor
GTCTTTATCGCTCTCA	Normal
ATGAAAGGTGATGAAT	Normal
AGCGATTGTCTCGCGA	Tumor
CGCATGGAGTGTAGTA	Normal
CTGTCGTCAGTGGTGA	Tumor
GGTGAAGGTCCGTTTC	Normal
AGGGCTCGTTAGAGAT	Normal
TGTTCTACATGGAGAC	Tumor
GGCGTCATCGGTTCAA	Normal
GCTTGGGAGTGTAGTA	Normal
GTGTGATAGTTTGAGA	Tumor
TACTTGTCAACTGCTA	Normal
CGCATAAGTAGCACAG	Normal
CGGAATTGTTTGCCGG	Normal
GAGTGAGAGAGTTCGG	Normal
GGAATCTTCTCGTCGT	Tumor
TTCGGTCCACTCCCTA	Tumor
TTGTTTGCAGTCTGGC	Tumor
CCTGTTGTCTGTGTGA	Tumor
TCTACCGTCAGCTCTC	Tumor
TCGTGGGCAGGTGGAT	Tumor
AGAGCCCGTGGCTGAA	Normal
TCTGCCATCAGATTGC	Normal
TATCCTAGTGAGCAGT	Normal
TTGTTCAAGAGCACTG	Tumor
AGTCAACCAGGCGATA	Tumor
TTTAGTCAGTCGCCAC	Normal
GAAACCTCATGGATCT	Normal
GTCGAATAGAGTGACC	Normal
CTCCCAATCGTCACCT	Normal
GATGGAGGTCCCGCAA	Normal
TCACTCGCACATATCG	Tumor
CGAAGGATCGCCTCTA	Tumor
TTCCACGGTCGCATCG	Tumor
CCTCATGGTATCAGGG	Normal
GGTAATCTCAGCTCTC	Normal
CGAGTTAAGTAGCTCT	Normal
TACCTGCCACTTGGCG	Normal
TGAGCATTCTAGCATG	Tumor
AAAGGGCTCGTAGTGT	Normal
AGGGAGTAGCTGGCCT	Normal
CCATCACCACAAAGTA	Normal
TTTGTTGTCTTTCGAT	Normal
GTGCGTGAGTTCCTGA	Tumor
TCAAGACGTGCCGAAA	Tumor
GTAGGTTCAGTATACC	Normal
GGTCTGGGTCACCCTT	Normal
CATTTCAAGAAACTGT	Tumor
ACTATGGAGGTTCCAT	Normal
GTGATGTTCACAAGAA	Tumor
TCCTGCATCTCTTGCG	Tumor
GTCATGAAGTGCACCC	Normal
ACACCAAGTCCGAAAG	Normal
GTAGCTACAATCTCGA	Normal
TCACTATTCTCTCTAA	Tumor
GAGTGTTAGTCCGCCA	Normal
ATCCGTCAGTAGACAT	Normal
TACTTGTGTACTCGTA	Normal
TTGGGCGTCTCTGACC	Normal
TAGGTACGTCGTCGGT	Normal
CGCAGGTAGCAAATCA	Normal
CGAATTGAGTGAGCCA	Tumor
GGATGTTGTTGGACCC	Normal
TGTGGCGCAAATCGGG	Normal
CATGCGGTCACTGGTA	Tumor
CTGTACCCAGCACGAA	Normal
CCTGCATTCCAAAGGG	Normal
GGGCCATCAATCCTTT	Normal
TATGTTCCAACAGAGC	Normal
TACCTCGAGCTAAATG	Tumor
GTGAGCCAGACCTTTG	Tumor
AGGGCCTAGGGTCAAC	Tumor
TCGAAGTGTCTGATCA	Normal
TCATTGTGTGATTCAC	Normal
TCGTGGGCAAGGATGC	Tumor
GGCTTGGCAAGACAAT	Normal
GTCATCCAGAGCTGCA	Normal
GCAGCCATCGTTGTGA	Normal
CATTCCGCATTGACTG	Tumor
ATGGTTGAGCTCGACC	Normal
TCGGGTGAGGGCAAGG	Tumor
ATAGACCAGATGACCG	Tumor
ATTTCTGGTGCGTCGT	Tumor
CCCTCTCTCCCATGGG	Tumor
TATGTTCTCAAGAGTA	Normal
CTCCATGAGAGTTCGG	Tumor
TTCAGGAGTAGCTTGT	Normal
CTCATGCGTGCTCCGA	Tumor
GTTCATTGTCAGGCAA	Tumor
ATCAGGTAGTAGTCTC	Normal
GGGTATTGTATCCTCC	Normal
CGGGTCAAGGCCCACT	Normal
CCGGTAGAGGGCAGAG	Tumor
TGCGGCATCTTTCAGT	Normal
TACGGTAAGCTGCCTG	Tumor
TCCTCCCGTTCCTTGC	Tumor
GTTGAACGTTCTTCAT	Normal
GAAGGGTGTTGATCGT	Tumor
GCACGGTTCGACATAC	Tumor
CTGCTCAGTCACCCTT	Tumor
CTCCATGAGGTAAGGA	Normal
TTGAGTGCAAAGACTA	Normal
GGGTCACTCCTGATAG	Tumor
AGTGACTAGGACTGGT	Normal
CTGAATGGTATACCCA	Tumor
GTAGGAGGTTACACTG	Normal
GAACGTTGTAAGCAAT	Tumor
TCGTAGATCAGCTGTA	Tumor
TTACAGGAGACCATAA	Tumor
GGCACGTGTACCTGTA	Tumor
GACAGCCTCCGTTGGG	Normal
GACATCATCGCTTTAT	Normal
GTCTTTAAGGTAGCAC	Tumor
TCGCTTGAGGTTGAGC	Normal
AGCCAATAGCAACAGC	Normal
GACTTCCGTATACAGA	Normal
TTCGGTCCATCCGAAT	Normal
GACGTTAAGGACTAAT	Normal
TGTCCACGTGCCGTAC	Normal
ATACCGACATGACGGA	Tumor
CGAAGTTGTGTTCAGT	Tumor
GACTCAACACACGCCA	Normal
GTCGTTCTCCACCTCA	Tumor
AGGACTTGTTAAGCAA	Normal
ATTCATCCATTCTGTT	Normal
CGACAGCAGTGCTCAT	Normal
AGACTCATCGGTGAAG	Normal
TGCGATATCCACAGCG	Tumor
CTAAGTGAGATAACGT	Normal
TGATCAGGTGTGTCGC	Normal
CATTTCAAGCATCCTA	Normal
TCATTTGCAGTCAGCC	Tumor
CCGGTAGAGATCCTAC	Tumor
GAGGGTAGTGTAAACA	Tumor
AGCCAGCCACATATGC	Tumor
CACTAAGTCGCCAATA	Normal
TCACAAGTCGCCTAGG	Normal
ATGCCTCGTTCGGACC	Normal
AACACACGTGCGGCTT	Normal
TGCTCGTCAAGTACCT	Tumor
AGGGAGTAGGTTTGAA	Tumor
TATTTCGCAGGGAGAG	Normal
ACCGTTCAGGCTGAAC	Normal
GCAGCTGAGCTCAGAG	Tumor
GTTGTAGGTAGCTGTT	Normal
CGAGTTACAAGAGAGA	Normal
CGTGAATAGTTGCGCC	Normal
ATTGGGTAGTGAGTGC	Tumor
TTTGACTAGTTGTACC	Tumor
AAGACTCAGGGCAGAG	Normal
GAAGTAAAGGTAAGTT	Tumor
AGACACTAGCAGTACG	Normal
ACTTATCGTGTTTACG	Normal
CGATGCGAGCCTTCTC	Tumor
GTAGATCGTGTACGCC	Normal
TGAGCGCCACGATTCA	Tumor
TCAAGACTCGATACAC	Normal
GAAGGGTAGGCTCTAT	Normal
TTTACCACAACGGTAG	Normal
TTTGACTCACAGTGTT	Normal
TCAATCTGTCCAGAAG	Normal
TGAGCATAGCTCATAC	Tumor
AGTGATCTCCTTACCG	Normal
CAGTGCGAGCGGACAT	Normal
CAATGACGTTAGGACG	Normal
GCAGCTGGTTCAACGT	Normal
CCCGAAGAGCTCTGTA	Normal
CGTCCATCACTCAGAT	Normal
CATGCCTAGAGCATCG	Normal
ACTATCTAGACTCAAA	Normal
CTGATCCAGAGTTCGG	Normal
GCCGTGAAGGATACAT	Tumor
TCGCAGGAGGTAACTA	Tumor
AGGCCACAGGGTAGCT	Tumor
TCTTTGATCGAGTCTA	Normal
CTGCAGGTCTCCGCAT	Normal
TGCAGATGTCGTATTG	Tumor
AACCTGACAAGCTACT	Normal
AGTTAGCGTCGAATGG	Tumor
CCTCTAGTCCGCAGTG	Tumor
TCGTAGATCGGTTCAA	Tumor
TACGGGCCAGAGGTTG	Tumor
CGTCAAACACCGAATT	Tumor
CCCGGAATCATCCCGT	Normal
ATGGGAGGTCGGATTT	Normal
AGACCCGCAGGTCTCG	Tumor
CAACGATGTGATGGCA	Tumor
TTGCGTCCAGCTATTG	Normal
TGGATCAGTGTGCTTA	Normal
AATCACGGTCAACCTA	Normal
GAGGCAAAGCGATGAC	Normal
TCACTCGAGCGATGGT	Tumor
AGAGCAGAGATCCAAA	Normal
CTCCACAGTGCAGATG	Normal
CTCCCTCTCCAAATGC	Tumor
TGCGGGTGTCCTGGTG	Tumor
ATCCACCGTTCGTGCG	Tumor
CCACGTTGTATGAGAT	Normal
CGCCAGAAGAGCCCAA	Tumor
TCACTCGTCGTAACCA	Tumor
TGAATCGGTGCCTGAC	Tumor
ACCAACACAACAAAGT	Normal
TTGAGTGGTCAACCAT	Normal
GGTTAACTCGTAGCCG	Normal
GTCGTTCCAGGCTACC	Normal
CCTTTGGTCAAGCCTA	Normal
CCGATGGTCATTTACC	Normal
TGTCCTGGTCTTGCGG	Tumor
CTTAGGACAATCTCGA	Normal
TCAGTGACAGAGGTTG	Normal
ACCTGTCAGTATGATG	Tumor
CATCGCTTCGATTGGT	Normal
TGATTTCAGTCAGCGA	Normal
CGTGTCTCAATAACGA	Tumor
TGGTACAAGAGCAACC	Normal
ATAGACCGTGTAGGAC	Tumor
TCGGGTGCAGTTCTAG	Normal
CGTGATAGTCAGTCTA	Normal
TCTCACGCAACCGGAA	Normal
CTCTGGTAGCAAGCCA	Normal
CCAATTTAGAGGTCGT	Normal
AATGGCTGTAGTGCGA	Tumor
CTCCCTCCATCGTGCG	Normal
AGATGAATCCAACCGG	Normal
AGATGAACATCATTTC	Normal
AGTACCAGTGTCTAAC	Tumor
GCATGATAGCTGAAAT	Normal
GTTGCTCCATTCCTAT	Tumor
AATGACCAGAATCGTA	Tumor
CTAGACATCTGTACAG	Tumor
CCAAGCGTCGGTCATA	Tumor
GCCATTCGTAGCTTTG	Normal
GTAGAGGTCTGAGGTT	Normal
AGTCATGCACGCACCA	Normal
AAATGGAGTAGAGACC	Tumor
GACTTCCCACTAGTAC	Tumor
CTGGTCTTCGCTATTT	Normal
CAGATTGTCAGGACGA	Tumor
CTTCAATGTCAAGTTC	Tumor
TCAGCAAGTCCGGTCA	Tumor
GTGCTGGAGATGGTCG	Normal
GATGAGGCAGGATCTT	Normal
GATCGTACAACGATCT	Normal
GTCCTCACACTACAGT	Normal
AGACAAAGTCACTCAA	Normal
ACGATCACAAAGACGC	Tumor
CTGGACGAGAGGTTTA	Normal
GGCAGTCGTCACTACA	Normal
AGTAGTCAGCAGGCAT	Normal
TTAATCCCAACCGATT	Tumor
TTGCCTGGTCTGCGCA	Tumor
TGGGCGTGTCCAGCAC	Tumor
GGCTGTGAGTCAAGCG	Tumor
TTCTCTCAGGGCAACT	Tumor
CATAGACCAATGTGGG	Normal
AGAAGCGGTTTGTTGG	Normal
AAGCGAGAGGAGAGGC	Tumor
TCGTGCTCACTAGGCC	Tumor
TCATTGTCAGAGTAAT	Normal
GGTGATTAGCTGACCC	Tumor
GTCTAGATCGCGTAGC	Tumor
ACATGCAAGTGCTAGG	Normal
AGATCGTAGAACGCGT	Tumor
TCTGCCACAGGGCTTC	Tumor
GCGATCGGTGCATTAC	Tumor
AATGAAGGTCTCTCTG	Normal
CTACTATAGCTGAAGC	Tumor
CACAGATCAAGTGGTG	Tumor
GGCACGTGTAAGCTCT	Tumor
ATAGGCTAGGCACGAT	Normal
TGTCAGATCAGGACGA	Tumor
ACCCTCAAGGGTACGT	Tumor
GGGCGTTTCTACGCAA	Normal
AAGTCGTGTAACTAAG	Tumor
TCAGCCTTCAAGCCGC	Normal
CTAACTTAGATCGACG	Tumor
AGGGCTCGTCTCACGG	Tumor
GTGAGTTAGCGCCATC	Normal
TTTGTTGTCCTAAACG	Normal
CTACGGGTCGCTGCGA	Normal
TCTACATAGTCCGCGT	Normal
TAAGCCACAATCTCTT	Normal
GAGTGAGAGGGAGGCA	Tumor
TATTCCAAGTCTGTAC	Normal
GTCATTTAGGTAGGCT	Tumor
TTCTCTCGTTTATGCG	Normal
GGAACCCTCTTTCAGT	Tumor
GTGGCGTAGACTACGG	Normal
GCCAGTGGTGATACCT	Tumor
TTAATCCGTACAGTTC	Tumor
CCCGGAAAGCTAGAAT	Normal
GGCTTGGGTGCAGTGA	Tumor
GTCGTTCCAGATCCAT	Tumor
GTAGGTTTCTCGAGTA	Normal
CAGGTATTCGTGACTA	Tumor
TGCTTGCGTGTAGTGG	Normal
ACTGTGAAGACCGCCT	Normal
TTGGGCGAGAAGATCT	Normal
TTGATGGCATGCCGAC	Normal
CTGTAGATCTGAATGC	Normal
CTCAGAACATCCTTGC	Tumor
AGGACTTTCATTGAGC	Tumor
CGAGTGCGTTCGAGCC	Tumor
AAGTTCGTCAAACGTC	Tumor
GTAGGTTTCTTCGTGC	Normal
GGAGCAATCGATTGGT	Normal
TAATTCCGTGTACAGG	Tumor
AGAGAGCGTGCGGTAA	Tumor
CAATGACAGTACCATC	Normal
TGTGTGACAATACCTG	Tumor
TGATTTCCAGGTTCAT	Tumor
CTATCCGGTGGCACTC	Tumor
TCCTCGAGTGCCCGTA	Normal
TCGTGGGAGGGCAATC	Normal
CCGATGGCAGTCGGAA	Normal
CCTCAGTGTGACCTGC	Normal
GCACTAAGTTGAAGTA	Normal
CTTCCTTCACGGCCAT	Tumor
GCTCAAAGTGCGAGTA	Normal
ATTGTTCTCCCAAGCG	Normal
ACGATCAGTACTCGCG	Tumor
GTGTAACTCAGGAAGC	Tumor
AAGGTAATCCTCGCAT	Normal
GTGCACGAGCCTCGTG	Tumor
GGCTGTGAGTGTTGAA	Normal
TCCCATGGTGGCCACT	Tumor
AGTCACAAGACAACTA	Normal
TCACACCGTCCAAAGG	Tumor
GCCCAGACACTATCGA	Tumor
GATTGGTGTAGATCGG	Tumor
GTCATTTGTCGAAACG	Normal
TTGTTTGTCCTACCAC	Normal
AAGCATCCATCCGAAT	Normal
AATTTCCGTCTACATG	Tumor
GTCTTTATCGCCGAGT	Normal
TTGCGTCCATTAGGAA	Tumor
CTTAGGAAGCCGTAAG	Normal
GTAGATCTCAGTCACA	Tumor
CGTGAATCACCCAATA	Tumor
TATCGCCCAATTCACG	Tumor
TGAATCGTCCATCTAT	Normal
ATCGTCCGTCGCTGCA	Tumor
GCGTTTCTCTTGTTAC	Tumor
ATCGTCCTCACTCCGT	Normal
GAAGGACGTTTAAGGA	Tumor
AACACACGTGCAATGG	Tumor
TTTACGTCATGCTGCG	Normal
CCTCATGAGGTTCTAC	Tumor
ACTCTCGGTGGTCAAG	Tumor
TCTTTGACAGTGACCC	Normal
CTGCGAGAGTTTAGGA	Normal
TAACGACCAATCAGCT	Normal
GAAGCGAAGACCATGG	Normal
CGTGAATCAATCGCCG	Tumor
TCCGATCCAGTCTACA	Normal
GGAATGGTCTGTGCAA	Tumor
TCATGTTAGCCTGTCG	Tumor
TCATGTTTCCGCAAAT	Normal
AAACGCTGTCCAATCA	Tumor
TACTTCATCACGACTA	Normal
AGTGCCGGTGTTATCG	Normal
CAGTGCGGTCGTGGAA	Tumor
TTACTGTCAGCGTATT	Normal
AGACACTCAAGACGGT	Normal
AAACGCTTCTATCGGA	Tumor
TGTTCTACACTGCGTG	Normal
ACTGTGATCAGACATC	Normal
AAGAACATCAATCGGT	Tumor
AAGTGAAGTCGTGTTA	Normal
GTCTTTAGTTTAGACC	Normal
AAGTACCGTAGTGTGG	Normal
TTGTTTGCAAATGGCG	Normal
TACTTGTAGCACTTTG	Normal
ATGTCCCAGTCCGTCG	Normal
ACCTGTCGTGCTTATG	Normal
TATTCCATCTAACACG	Tumor
AACAAAGGTCTGTGTA	Tumor
GACCGTGGTGTTACTG	Tumor
TGTTTGTCAAAGGTTA	Tumor
GAGTCTATCTCGTTTA	Tumor
AGATGAATCACCTCAC	Tumor
CAATTTCGTTCAAGTC	Normal
GTCGTAATCTATTCGT	Tumor
CCGATCTTCTACGGGC	Tumor
TGGATCAGTGCCTTCT	Normal
GACTGATCAACATCGT	Tumor
ACTTCCGTCGGTAACT	Tumor
TTAGTCTTCATAGACC	Tumor
TCGGGACTCCTCTGCA	Tumor
AGGTTGTCAAATGCGG	Normal
CGACAGCCAATTGCAC	Normal
TTCTTGATCTCTATGT	Tumor
GTGCTGGGTCATTGCA	Normal
GTCAAGTAGAGCAAGA	Normal
TCTTTGAGTCAGTCTA	Normal
GAGTTACGTATCAAGA	Tumor
CGAGGAATCGTGTGAT	Normal
GCAACCGAGCATCAGG	Tumor
CACGGGTAGTTGTCGT	Normal
CATGAGTGTGCGTCGT	Normal
ATGAGGGCACTTCTCG	Normal
AGGACGACATACTGAC	Normal
TGGAGGACAATTTCTC	Tumor
ACTATTCAGTAGGGTC	Tumor
TCTCCGAAGGTTGTTC	Tumor
ACTATTCGTCCTCAGG	Tumor
TAGACCAGTACGACAG	Normal
ATGTCCCAGGTATTGA	Normal
CCGGACAAGACATCCT	Normal
TAGACTGAGCATGGGT	Tumor
TGTGAGTGTCGTGGTC	Normal
ATATCCTAGCAAGTCG	Normal
GGACGTCGTGGGAGAG	Normal
TTCCTAAAGCTGAAAT	Normal
GCGATCGCACGGTGAA	Normal
ATGACCAAGTGCTCGC	Normal
TGATGGTGTTCGGACC	Tumor
GCGTGCAAGTACTCGT	Tumor
AAAGGGCCATGGCCCA	Tumor
CATCGGGCAACTACGT	Normal
AGCCAATAGCGACATG	Normal
CTGGACGTCTATACTC	Tumor
ACTTCGCGTGTTGAGG	Tumor
TCAAGCAGTTGAGTCT	Normal
ATACCTTGTCCAGTTA	Tumor
TCAAGACGTCGGCCTA	Normal
ACGGTTAAGTTCAACC	Tumor
CTTACCGGTCTGATAC	Normal
AGCTACACACTACACA	Tumor
ATGGGTTAGAATTGTG	Normal
TCATTACCATGGGTTT	Normal
GGGATGATCTAATTCC	Normal
TTGTTCAAGGTAGACC	Normal
GATGTTGTCTCCGTGT	Normal
TCATGTTGTCCTCCTA	Normal
AGAACAATCCGTGTCT	Normal
TTGGATGAGCAATTAG	Normal
TTCAATCTCGTTCAGA	Normal
TGAACGTAGTAGCCAG	Normal
ATTACCTGTCCGTTTC	Normal
GTCGAATAGAGCGACT	Normal
TTTCATGCATGGTGGA	Normal
ATTCCATTCCGATAAC	Tumor
GGTCTGGAGAAGCTCG	Normal
TATCGCCAGTAATACG	Normal
CACTTCGGTTTACTTC	Normal
ACTGATGTCCGAAATC	Normal
CTGTAGACAACAAGTA	Normal
CCCTGATAGGCGTTAG	Normal
AGGATCTAGCGTCGAA	Normal
GTCTTTACAGAATCGG	Tumor
TTCTTGAGTTTCCATT	Normal
ATATCCTGTTGGAGGT	Normal
TAATTCCCATGGCCAC	Tumor
GTAAGTCCATAACAGA	Normal
CCTCCAAAGCGATGCA	Normal
CCGGACAGTCGTCGGT	Normal
ATCACTTCACGCGGTT	Tumor
TATTGGGAGTCAGGGT	Normal
GGAGCAAGTTCACGAT	Tumor
GTAGAAAAGATGCTGG	Normal
TCGTAGATCGGTTAGT	Normal
GATGACTTCCGATGCG	Normal
AGAGCCCAGCCTTGAT	Tumor
TGCTTCGAGGAAGTGA	Tumor
CAGATTGTCCAACCGG	Normal
CAAGACTAGGAAGAAC	Normal
ATAGACCAGTATCCTG	Normal
GTTTGGATCTTCGGAA	Tumor
ATGGATCGTATCGCTA	Normal
CTGGCAGCAAATCGGG	Normal
GATCCCTAGTATGTAG	Tumor
TCACTCGCACCGTGGT	Tumor
CCACGTTTCATGTCTT	Tumor
TAACGACAGATCCGAG	Tumor
TGTCCACCAGGAGGTT	Normal
TCTTAGTGTTCGCGTG	Normal
TAGAGTCAGTCAGAGC	Normal
TACGGGCCAGCAGACA	Tumor
GGATCTATCACTCGAA	Normal
GAACACTTCTGCCCTA	Tumor
GGGCCATCAGACGCTC	Tumor
TACACCCGTGACTCTA	Tumor
TCCTTCTCACTCCTGT	Tumor
ATTTCACCAAAGACGC	Normal
AGCTACATCATCGCCT	Tumor
AGCTTCCAGGAACATT	Normal
CAGGTATTCTATCGGA	Normal
ACGGGTCCATGTCTAG	Normal
GCAGTTACACGTGAGA	Normal
AGGGTCCCATCGGAGA	Tumor
AAGACAAGTCATGACT	Normal
CGAAGTTTCATTGTGG	Tumor
CCTTCAGTCTCAGTCC	Tumor
AAGTCGTAGGTCCCTG	Tumor
ACATTTCAGTGAATAC	Normal
GACTCAATCTTAGGAC	Normal
GGGTGAACAGTCGTTA	Normal
TTGAGTGGTCGTTCAA	Normal
GGGTATTGTAACGTTC	Normal
CTCCGATTCGCTGCGA	Normal
CAATACGGTACCCACG	Normal
CCTCTCCTCCTACCAC	Tumor
CTGCAGGTCACGGTCG	Normal
GCGTTTCTCCATGAGT	Normal
GCCGTGAAGACCATGG	Tumor
CATGCTCCAAGTCATC	Normal
AGCGTATAGTTGAATG	Normal
TGCTCGTCAATAACGA	Normal
TGTACAGTCGTTAGAC	Tumor
TCATGCCCACATTACG	Tumor
GCTACAATCTGCTGAA	Normal
GAAATGAAGGGATCAC	Normal
GTAGTACTCGAACGCC	Tumor
ATTACTCGTGTTCGTA	Tumor
GAGTTTGGTATCTCTT	Tumor
CGTCCATTCGTACACA	Tumor
AGCGTCGCAAGATGGC	Tumor
TGTTCTATCTGTCGCT	Normal
GAAGCCCCATGGGAAC	Normal
AACCATGCAACGATTC	Normal
GGGTCACGTTACAGCT	Normal
TTTACCAAGCAGGGAG	Tumor
GAGTCATAGCTGTCCG	Normal
TTGGGATAGCATCCTA	Tumor
TGCTCCACAAGCGAGT	Tumor
GTCGTAAAGCATCCCG	Normal
TCGTAGAGTAGCTGAG	Tumor
AAATGGAAGTCTGCGC	Normal
GAATAGATCCGACGGT	Normal
ATTACCTCACTCCTTG	Normal
CAGTGCGTCTATCGGA	Normal
TCCACGTTCGTCAGAT	Tumor
ACTCCCAGTTGGGATG	Normal
GAATCACAGTGGAAGA	Tumor
CTTGAGATCCATAAGC	Tumor
GCGTTTCTCTAGACAC	Normal
GGTCTGGTCCTACCGT	Normal
CTAGGTAGTGTTTCTT	Normal
CGTCCATTCGCTGACG	Normal
AGGACTTTCTGCCTGT	Normal
GGTAACTCATTGGGAG	Tumor
TTCGCTGGTGTAACGG	Tumor
AGGGTCCCAATTCACG	Tumor
TCGTGGGAGCCTCACG	Normal
GGGAGATGTCAGTCCG	Tumor
GAAGCCCCAGACCCGT	Normal
TCGACCTAGGAACTAT	Normal
TGGTGATTCTTAGGAC	Tumor
AGAACCTAGATTACCC	Normal
TTGATGGTCCAGTGCG	Normal
GTATTTCTCTTGGTCC	Tumor
TTTACCAGTGGGAGAG	Normal
CATTCATTCCGAACGC	Tumor
ATAGGCTAGTCGAGGT	Tumor
ACTGTGAAGTGAGGCT	Tumor
TACTTACGTCAGTCTA	Normal
CCGCAAGAGCCTCTGG	Tumor
GTCGAATTCCACACAA	Normal
CTGAATGGTGGATCAG	Tumor
TAGACTGAGGTAGTAT	Tumor
GGTAACTCAAGAGTGC	Normal
GGAGGTAGTGGTACAG	Normal
GTGCTTCGTTGCTGAT	Tumor
GTCGCGAGTTGGTAGG	Normal
CTCAACCCAATCGCAT	Normal
ACCCAAAAGGTTAAAC	Tumor
TTTCAGTCATACAGGG	Normal
GCATGATGTCACTTCC	Tumor
ACGGTTAAGTCATGAA	Normal
GCTACCTCAAACTAAG	Normal
AATTCCTCATCGAACT	Tumor
GGAGCAAGTGCGAGTA	Normal
TAGGTACCAACCCTCT	Tumor
CCACGAGAGGCCCAAA	Normal
TGACTCCGTGGATGAC	Normal
CAACAACAGCCATCCG	Normal
CATCGCTTCAAGTCTG	Tumor
GCCGATGCACCAGCGT	Tumor
GCTCAAACAAGCTGTT	Normal
CGCCATTCAAATGAAC	Tumor
ACAAAGATCTGCTAGA	Normal
AGACAGGGTACGGTTT	Normal
TGGGCTGAGCTGGCTC	Normal
GACAGCCCAGCTTCGG	Tumor
ACTGTGACATGCCGAC	Normal
TTTCGATTCTAAGGAA	Tumor
AAGTACCGTTGCAACT	Tumor
CGGGTGTCATCACCAA	Normal
TCTGGCTTCCCTCTCC	Tumor
CATCAAGGTGCTCGTG	Normal
TAGAGTCAGGGTAATT	Normal
CAAGAGGTCGCGAAGA	Tumor
TGGTACACATTGCCGG	Tumor
TCAATTCAGCACAAAT	Normal
TTTCCTCTCGCGGACT	Tumor
AGGTAGGGTGAGCTCC	Normal
CACTTCGAGACGAAGA	Tumor
CCATCACGTTCTTGTT	Normal
ACGTAGTCATATAGCC	Normal
ATTATCCTCCATTCGC	Tumor
AATCGACTCGGACTTA	Tumor
AGGCTGCGTCGAAACG	Normal
CCGGGTAAGGCAGTCA	Tumor
TGGCGTGTCGAGAAGC	Tumor
GAGCTGCGTTTGATCG	Normal
TAAGCCATCTTAGCTT	Normal
GTCATGAAGTAGGGTC	Tumor
ATGGGTTTCATGAGTC	Tumor
CACGAATGTGGAACAC	Normal
ACTGCAAGTACACGCC	Normal
TGGTACAGTTAAACCC	Normal
TCAGTTTTCTACTTCA	Normal
AAGTCGTTCGTTGTGA	Normal
GAAGGACAGCACACCC	Tumor
AGAAGTAAGCTATCTG	Normal
GCGAGAAAGATGGTCG	Normal
AAGTCGTGTCGGCACT	Normal
ACTATTCTCCTTCGAC	Tumor
ATTGGGTCACCGTGAC	Normal
CATCCGTCAAAGAACT	Normal
GTTGAACCAATCGCAT	Normal
ACGGAAGCAGCGTGAA	Tumor
GTAGAAATCCCGAAAT	Normal
TTGGGCGTCGCAGATT	Tumor
ATTCATCCAGGCACAA	Normal
ACCCTTGTCGAGAAAT	Tumor
CAGATACGTGGTATGG	Tumor
CTCAATTAGGGTCAAC	Tumor
TTTCAGTTCGAATCCA	Tumor
CTACCTGCATGTCGTA	Normal
CCTAACCCAGCGTAGA	Normal
AAAGGTACAAGTGACG	Tumor
CCGTTCAGTTCAGCGC	Tumor
TGAACGTTCCATCTCG	Tumor
AGGGCCTGTATCGTAC	Tumor
TAGGAGGCAGCACACC	Normal
TGAGTCACAGTGTATC	Tumor
GCCGATGAGATCGACG	Tumor
TTGCGTCAGGAGCTGT	Tumor
TGGTTAGTCCAAGCTA	Normal
GCCATGGGTTGAAGTA	Normal
GGTCACGTCTTGAACG	Tumor
AAATGGACATCGTCCT	Normal
GTGGTTAAGCATGCGA	Tumor
GCATTAGCAGACACAG	Tumor
CGTGCTTCAGCAGTAG	Tumor
CGGGACTGTCCTCCAT	Normal
GTGCAGCAGGTATTGA	Normal
GCGTGCAAGAGCCGTA	Normal
GTTGTAGTCGACACCG	Tumor
TCATGGATCGTGCATA	Tumor
ACACAGTAGTAACCTC	Tumor
AGACAAAAGCCTAGGA	Normal
ACGTCCTAGAAGCGAA	Tumor
GTCGAATCATCGGAAG	Normal
AGATAGAGTCGCCACA	Normal
GACGTTAGTATCTCTT	Normal
ACAGGGATCACCGACG	Normal
AAAGGGCCATGGAAGC	Tumor
AGAGAGCCAGGTTCGC	Normal
CGTTGGGTCTGACGCG	Normal
GAGTTTGTCTGGCCGA	Normal
CGTGCTTAGGAGCTGT	Tumor
TGTTGAGCAGGACTTT	Normal
AATGAAGAGCTTGTTG	Tumor
CGAGGAATCTGGGAGA	Tumor
TGCAGTATCGGTATGT	Tumor
AGTTCCCAGAAACCCG	Tumor
CATCCCAAGAGTCTGG	Tumor
TTCTTGACACTCCTGT	Tumor
ATGGATCTCGGCGATC	Normal
TAATCTCGTGAGTAGC	Tumor
TCGTGGGCAGTGACCC	Tumor
GCCGTGAAGGCAGGTT	Normal
TCACGCTGTCATACCA	Normal
TTTCGATGTGGCTACC	Normal
AGAGAATCAGCAGGAT	Normal
GTTGCGGTCCGCGGAT	Tumor
TGTAGACCATCGAGCC	Tumor
ATTTCACTCCGTCCTA	Tumor
AATGGCTAGGTGCCTC	Tumor
ACACAGTAGGAACTAT	Normal
TCTATACCAACGAGGT	Tumor
CCAATTTAGCACTGGA	Normal
AGACAGGAGGCGTTAG	Tumor
AGACAAAAGAAAGTCT	Tumor
TTCTAACTCGGTAGAG	Tumor
TGTTCATGTCCACTCT	Normal
TCATGAGAGCCAGTAG	Tumor
TCATGGAAGTGCTCAT	Tumor
ACAAAGACATGGAATA	Normal
TGCAGTAAGGTACATA	Tumor
ATTCCCGTCTCCAATT	Normal
CACCAAAGTCGAGTGA	Tumor
TACCTGCAGCACTGGA	Tumor
TCCTCGACAGGTGTGA	Tumor
CTACGGGAGATGTAGT	Normal
ACTTATCGTGCGTCGT	Tumor
GCTACCTTCGGTCACG	Normal
GACCAATTCCATCGTC	Tumor
AGAGCCCCACGTAACT	Normal
ACTATCTTCTCATAGG	Normal
CTTCTAACAGATACCT	Tumor
TCCTGCATCTCTCGAC	Tumor
TCGTCCACAGGTGACA	Tumor
TCACACCCAGAGGAAA	Normal
CGAGGCTGTCTCTCAC	Normal
TGGTGATGTAAGATCA	Normal
GATGACTGTCCAGCAC	Normal
ATCGTGAAGGCTCTCG	Tumor
AGGGTCCGTAAGATCA	Normal
TCATTCACAACCGCCA	Normal
TCTACATGTGCAACAG	Normal
GTCGCGAAGGAATGTT	Normal
TTAGGCATCCGGTAGC	Tumor
ATGGAGGTCCACTGAA	Normal
AGAAGTAGTAGCCAGA	Tumor
GTAGTACAGAACAGGA	Tumor
ATGCGATGTCGCATCG	Normal
CTCTCGACAGGGTCTC	Tumor
ATGGATCTCTTGGAAC	Tumor
CTCAGGGAGTAAACTG	Normal
TTAGTCTGTCTTAGTG	Tumor
ATCGTGATCCTCGATC	Normal
TTGTTCATCTACCTTA	Tumor
ATTCTACTCAAACGAA	Normal
GAGAAATTCTCTGAGA	Normal
CGGAATTGTCAGCGTC	Normal
TCAAGACTCCCTCGAT	Tumor
CATGCAACATGTTCAG	Normal
AGCATCATCATTCGGA	Tumor
CGGGACTCAGTATGAA	Normal
AAAGTCCGTCGAAACG	Tumor
TTCTAACCAACACGAG	Normal
CGCATGGTCCAACCAA	Normal
TGCATCCTCACCATGA	Normal
CGAAGGAGTGAGAGGG	Tumor
AAAGTCCTCCGCAACG	Normal
AGGAGGTCATTGGCAT	Normal
CTACTATAGGTAAGAG	Normal
CGTTCTGTCCCTATTA	Normal
GGAACCCCAATTAGGA	Tumor
CACACAAGTCACTAGT	Tumor
TTCGGTCAGTCCGTCG	Normal
TGAATCGTCCATCTGC	Normal
TCAATTCTCCGATGCG	Tumor
CAATCGAGTATATGGA	Tumor
TACAGGTTCATTTACC	Normal
GCCAGGTGTTGGGTAG	Tumor
ATGGTTGCAACAACAA	Normal
CGAAGTTAGAAGGTAG	Normal
TGGAACTAGGCATCGA	Tumor
GACTCTCAGTTACTCG	Normal
AACAACCAGGTAGTCG	Normal
GTCGTAAGTGCTCGTG	Tumor
GTCAGCGCAGGTCAAG	Tumor
CCTCCTCCACAGTCAT	Tumor
GTAGATCGTCTGTGAT	Normal
TCCATGCGTGAATTGA	Tumor
GTAGCTACACTCCGGA	Normal
AGCGTCGGTATTCTCT	Normal
GTAATGCTCGAGATAA	Tumor
CCAATTTGTCTTCCGT	Normal
ACAGAAAAGAGATTCA	Normal
TCGAACAAGTGTAGTA	Normal
CGGGCATAGGTAGTCG	Normal
CAACGATCACCATAAC	Tumor
CAGATCAAGGTTGCCC	Tumor
ATCGCCTCAGTGTACT	Tumor
AGTCAACTCAGAGCGA	Normal
ATTATCCGTGACAACG	Tumor
TCCCACATCCTGCCAT	Normal
GCTCAAATCCTAGCTC	Normal
AGCGCCACACTTGACA	Normal
CCCTCTCCAATTGCAC	Normal
ACCCAAAGTTGCTTGA	Tumor
TACCCACGTTCGCGTG	Normal
TCATGTTTCCCGAAAT	Normal
TCTCCGAAGAGCATAT	Tumor
TACAGGTGTCCTACGG	Normal
GGTGAAGAGTGCGTCC	Tumor
TGAGCATCAGACAAAT	Normal
TCCTCGATCGTCTCAC	Tumor
CGATCGGAGGAACGTC	Normal
ATCTTCATCATGCCCT	Tumor
GACGTTATCCTGTTAT	Tumor
GTCTCACCATGACCCG	Normal
CTCATTAGTCAACCTA	Normal
CCGAACGTCATGCCAA	Tumor
AGGTGTTAGCCTGGAA	Tumor
CCCAACTTCCAGCTCT	Normal
CTAGACATCTGCGGCA	Tumor
TACCCGTAGTCTGCGC	Normal
GGCACGTAGGAACGTC	Normal
GGGAGTAAGATGTAGT	Tumor
GCTCAAATCTCGGCTT	Tumor
TAGAGTCGTCGAAACG	Normal
ACGTACATCTTCACAT	Normal
AGGGCTCTCGCAAGAG	Normal
AACGAAACACAGCTTA	Normal
TGTGGCGTCAGCGTCG	Normal
CTAACTTGTGTCCATA	Normal
TCACTATCACTGGACC	Normal
TTTGTTGAGAAGTCTA	Tumor
GTGTCCTAGTCCCAAT	Tumor
AGCTTCCGTAGTCGTT	Normal
TCGTGGGGTATACGGG	Normal
GAGATGGTCACTGCTC	Tumor
AGGAATAAGGCTCCCA	Tumor
TGCAGATAGAGCCCAA	Normal
TCGCTCATCCCATACC	Normal
TTCTTCCTCTGGCCGA	Tumor
ATGAAAGCAAGAAATC	Normal
TAACTTCCACAAAGCG	Normal
TTGCGTCAGATAACAC	Tumor
GTTCGCTCACGTCGTG	Normal
TGTCCCACATTAGGAA	Tumor
ATCGTCCAGAAACTGT	Normal
CCCTCTCCACATGAAA	Normal
GGGTTTATCAACCCGG	Tumor
CGTTGGGAGCTCATAC	Tumor
CGAGAAGCAATGACCT	Normal
TGCGACGAGACTAGAT	Normal
TGATCAGTCTGGCCGA	Tumor
CGATGCGAGACTACGG	Normal
TTCTGTAGTGCATGTT	Tumor
TTCCGTGCATCATTGG	Normal
CACTGAACACAAGGTG	Tumor
TAACCAGGTCTCTCTG	Tumor
TGATGGTAGTAATTGG	Normal
GGCTTTCCATTGCTGA	Normal
GATTCTTGTACAGCGA	Tumor
GTGTTAGGTACCGTCG	Normal
AAGACAATCGTGCATA	Tumor
TCACAAGAGGACGGAG	Normal
CATACTTCATAATGAG	Normal
TATATCCCAACTGGTT	Tumor
CGAAGGACATATTCGG	Normal
GTCTTTACAGCGTGAA	Tumor
TCGGGCACACTTGGGC	Tumor
GCAACATCAAATGGCG	Tumor
AGACAAATCTCATGGA	Tumor
TTCCTTCCATTGACTG	Normal
CGTGCTTTCTAGGAAA	Normal
CCTGTTGTCATGGCCG	Tumor
TCGGTCTGTCGTAATC	Normal
GAGTGTTAGGCCACCT	Normal
CATACAGAGTATGACA	Tumor
CAGTTCCGTCGAAGCA	Normal
AACCACACATATGAAG	Tumor
AGCATCATCACAGTGT	Tumor
TCTCAGCGTCCTCCAT	Tumor
TCATGGATCAGAGCGA	Normal
GTCAAGTTCCGCATAA	Tumor
CCAAGCGGTGCGACAA	Normal
CCTATCGGTACTCGCG	Tumor
GAATCGTGTCGTGGTC	Tumor
TGGAGGAGTCAGACTT	Normal
GTCTGTCTCCATTCAT	Normal
GAGATGGTCGCATTAG	Tumor
ATGACCACATTGCAAC	Normal
TTCATGTAGTGTTCAC	Normal
CGAGGAATCTACTGCC	Normal
CAGATTGAGTGATTCC	Normal
TTGTTTGTCTTCCTAA	Tumor
GGGAGTAGTTTGCAGT	Normal
TCGCTCAAGAAGCTCG	Normal
CGGGTCACAAATCAGA	Tumor
TCTACATAGCGATGCA	Tumor
ATTCCCGTCTATGCCC	Normal
CTATAGGTCATCGACA	Tumor
GTCTACCCAATAGTAG	Tumor
TTCGGTCGTCTTCCGT	Tumor
ACCTGAAAGAGGATGA	Normal
AGTGACTTCATTCCTA	Normal
GGAGATGGTAGCTAAA	Normal
GCCAGCATCGCTGTCT	Normal
GAAATGACAATTAGGA	Normal
GTCATGAAGGTTCCAT	Normal
TATCGCCAGTCACTGT	Tumor
TCCTCGATCTTTGCAT	Tumor
CTCCTCCAGGCCTTCG	Normal
GTGTTAGCACTGTTCC	Normal
TTGGTTTGTGATACCT	Normal
TTCACGCAGGATGTTA	Tumor
CACCAAAGTGAAAGTT	Tumor
TTCGGTCCAGGAGACT	Normal
